a = неопределенный артикль
the = определенный артикль
be = быть
of = предлог родительного падежа
and = и
in = через
to = к
have = иметь
it = этого
for = для ; ибо
I = я
that = тот ; что
you = ты ; вы
he = он
on = на
with = с
do = делать
at = у
by = предлог творительного падежа
not = не
this = это
but = но ; кроме
from = от
they = они
his = его
she = она
or = или
which = который
as = как ; так как
we = мы
say = сказать
would = бы
can = уметь ; мочь
if = если
their = их
go = ходить ; идти
what = что
there = там
all = все
get = получать
her = ее
make = делать
who = кто
out = вне
up = вверх
see = видеть
know = знать
time = время ; раз
take = брать
them = им
some = несколько ; какой-то
could = мог
so = такой ; поэтому
him = ему
year = год
into = в
its = свой
then = затем
think = думать
my = мой
come = приходить
than = чем
more = больше
about = о ; около
now = сейчас
last = прошлый ; продолжаться
your = твой ; ваш
me = мне
no = нет
other = другой
give = дать
just = только что ; справедливый
should = следует
these = эти
people = люди
also = также
well = хорошо
any = любой
only = только ; единственный
new = новый
very = очень ; тот самый
when = когда
may = мочь
way = путь ; способ
look = смотреть ; выглядеть ; взгляд
like = любить ; нравиться ; как
use = использовать ; применение
such = такой
how = как
because = потому что
good = хороший
find = найти
man = человек ; мужчина
our = наш
want = хотеть
day = день
between = между
even = даже
many = много
those = те
after = после
down = внизу
thing = вещь
tell = сказать кому-то
through = сквозь
back = назад ; спина
still = все еще ; тихий
must = должен
child = ребенок
here = здесь
over = над ; выше ; пере- ; движение через
too = тоже ; слишком
put = положить
own = собственный
work = работа ; работать
become = становиться
old = старый
government = правительство
mean = иметь в виду
part = часть
leave = покинуть
life = жизнь
great = великий ; великолепный
where = где
case = случай ; коробка
woman = женщина
seem = казаться
same = тот же самый
us = нас
need = нужда ; нужно
feel = чувствовать
each = каждый
much = много ; очень
ask = спрашивать ; задавать
group = группа
number = число ; номер
yes = да
however = однако
another = другой
again = снова
world = мир
area = территория ; площадь
show = шоу ; показывать
course = курс
under = под
problem = проблема
against = против
never = никогда
most = самый
service = служба
try = стараться
call = звонок ; звать ; звонить ; называться
hand = рука
party = вечеринка ; партия
high = высоко ; высокий
something = что-то
school = школа
small = маленький
place = место ; размещать
before = до
why = почему
while = в то время как ; пока ; промежуток времени
away = отстоящий
keep = хранить ; держать ; продолжать
point = точка ; смысл ; указывать
house = дом
different = различный
country = страна ; сельская местность
really = в самом деле
provide = обеспечить
week = неделя
hold = держать ; проводить
large = большой
member = член
off = прекращать
always = всегда
next = следующий
follow = следовать
without = без
turn = очередность ; поворачивать
end = конец ; заканчивать
local = местный
during = в течение
bring = нести
word = слово
begin = начинать
although = хотя
example = пример
family = семья
rather = скорее
fact = факт
social = общественный
write = писать
state = государство ; штат ; утверждать
percent = процент
quite = довольно
both = оба
start = старт ; начинать
run = бег ; бежать
long = длинный
right = правый ; право
set = набор ; установить
help = помогать ; помощь
every = каждый
home = дом ; домашний
month = месяц
side = сторона
night = ночь
important = важный
eye = глаз
head = возглавлять ; голова
question = вопрос ; сомневаться
play = играть ; пьеса
power = власть ; сила
money = деньги
change = изменение ; сдача ; менять
move = двигаться
interest = интерес ; процент прибыли
order = приказ ; порядок ; заказывать
book = книга ; заказать
often = часто
young = молодой
national = национальный
pay = платить
hear = слышать
room = комната
whether = ли
water = вода
form = форма ; бланк ; формировать
car = автомобиль
others = другие
yet = еще не ; однако
perhaps = возможно
meet = встретить ; познакомиться
till = до
though = хотя
policy = политика
include = включать в себя
believe = верить
already = уже
possible = возможный
nothing = ничего
line = линия
allow = позволять
effect = эффект
big = большой
late = поздний
lead = руководство ; вести
stand = стоять ; стойка
idea = идея
study = учеба ; кабинет ; учиться
lot = много
live = жить
job = работа
since = с тех пор как
name = имя ; называть
result = результат
body = тело
happen = случаться
friend = друг
least = наименьший
almost = почти
carry = нести
authority = власть
early = рано
view = взгляд ; обозревать
himself = он сам
public = общественный ; народ ; публика
usually = обычно
together = вместе
talk = беседа ; беседовать
report = доклад ; сообщать
face = лицо ; стоять лицом к
sit = сидеть
appear = появляться
continue = продолжать
able = способный
political = политический
hour = час
rate = пропорция ; ставка
law = закон
door = дверь
company = компания
court = суд
little = маленький ; немного
because of = из-за
office = офис
let = позволить
war = война
reason = причина
less = менее
subject = предмет
person = лицо ; человек
term = термин ; срок
full = полный
sort = сорт ; вид ; сортировать
require = требовать
suggest = предлагать ; предполагать
far = далеко
towards = к
anything = ничего
period = период
read = читать
society = общество
process = процесс
mother = мать
offer = предложение ; предлагать
voice = голос
once = как только ; однажды
police = полиция
lose = терять
add = добавлять
probably = вероятно
expect = ожидать
ever = когда-нибудь
price = цена
action = действие
issue = выпуск
remember = помнить
position = позиция
low = низкий
matter = дело ; вопрос ; факты ; иметь значение
community = община
remain = оставаться
figure = цифра
type = тип
actually = вообще-то
education = образование
fall = падать ; упадок ; осень
speak = говорить
few = мало
today = сегодня
enough = достаточно
open = открытый ; открывать
bad = плохой
buy = покупать
minute = минута
moment = момент
girl = девочка ; девушка
age = возраст
centre = центр
stop = остановка ; остановить ; остановиться
control = контроль ; контролировать
send = посылать
health = здоровье
decide = решать
main = главный
win = победить ; победа
wound = рана ; ранить
understand = понимать
develop = развивать
class = класс
industry = промышленность
receive = получать
several = несколько
return = возвращение ; возвращаться
build = строить
spend = проводить время
force = сила ; принуждать
condition = условие
itself = сам
paper = бумага ; газета
themselves = они сами
major = главный
describe = описывать
agree = соглашаться
economic = экономический
upon = на
learn = учить
general = генерал ; общий
century = век
therefore = поэтому
father = отец
section = раздел
patient = терпеливый ; пациент
around = вокруг
activity = мероприятие
road = дорога
table = стол
cow = корова
including = включающий
church = церковь
reach = достигать
real = реальный
lie = лгать
mind = ум ; возражать
likely = вероятный
among = среди
team = команда
death = смерть
soon = скоро
act = акт ; действие ; действовать
sense = смысл ; чувство ; чувствовать
staff = персонал
certain = определенный
student = студент
half = половина
language = язык
walk = прогулка ; ходить пешком
die = умереть
special = особый
difficult = трудный
international = международный
department = отделение
management = управление
morning = утро
draw = рисовать карандашом
hope = надежда ; надеяться
across = через
plan = план ; планировать
product = продукт
city = город
committee = комитет
ground = земля
letter = письмо ; буква
create = создавать
evidence = свидетельство
foot = нога
clear = ясный ; очищать
boy = мальчик
game = игра
food = еда
role = роль
practice = практика
bank = банк ; берег
else = еще
support = поддержка ; поддерживать
sell = продавать
event = событие
building = здание
behind = за ; сзади
sure = уверенный
pass = передавать ; проходить
black = черный
stage = стадия
meeting = встреча
hi = привет
sometimes = иногда
thus = таким образом
accept = допускать
available = наличный
town = город
art = искусство
further = дальнейший
club = клуб
arm = рука
history = история
parent = родитель
land = земля ; приземляться
trade = торговля ; торговать
watch = часы ; наблюдать
white = белый
situation = ситуация
whose = чей
ago = назад
teacher = учитель
record = запись ; записывать
manager = управляющий ; менеджер
relation = связь ; отношение
common = общий
system = система
strong = сильный
whole = целый
field = поле
free = свободный
break = ломать ; перерыв
yesterday = вчера
window = окно
account = счет
explain = объяснять
stay = остановиться
wait = ждать
material = материал
air = воздух
wife = жена
cover = крышка ; покрывать
apply = обращаться
love = любить ; любовь
project = проект
raise = поднимать
sale = продажа
relationship = отношение
indeed = в самом деле
please = пожалуйста
light = светлый ; легкий ; свет
claim = требование ; требовать
base = основа ; база ; базироваться
care = заботиться ; забота ; осторожность
someone = кто-то
everything = всё
certainly = конечно
rule = правило ; управлять
cut = резать
grow = расти ; выращивать
similar = подобный
story = история ; рассказ
quality = качество
tax = налог
worker = рабочий
nature = природа
structure = структура
necessary = необходимый
pound = фунт
method = метод
unit = часть
central = центральный
bed = кровать
union = союз
movement = движение
board = доска ; совет
true = правдивый
especially = особенно
short = короткий
personal = личный
detail = деталь
model = модель
bear = медведь ; носить ; рождать
single = одинокий
join = присоединяться
reduce = сокращать
establish = учреждать
herself = она сама
wall = стена
easy = легкий
private = частный
computer = компьютер
former = бывший
hospital = больница
chapter = глава
scheme = схема ; план
bye = пока
consider = полагать
council = совет
development = развитие
experience = опыт
information = информация
involve = вовлекать
theory = теория
within = в
choose = выбирать
wish = желать ; желание
property = собственность
achieve = достигать
financial = финансовый
poor = бедный
blow = дуть
charge = ответственность ; загружать
director = директор
drive = водить машину ; катание ; езда
approach = подход ; приближаться
chance = шанс
application = приложение
seek = искать
cool = крутой ; прохладный
foreign = иностранный
along = вдоль
top = верхний ; верх
amount = количество
son = сын
operation = операция
fail = потерпеть неудачу
human = человеческий ; человек
opportunity = возможность
simple = простой
leader = лидер
level = уровень
production = продукция
value = стоимость
firm = крепкий ; фирма
picture = картина
source = источник
security = безопасность
serve = служить
according = соответствие
business = дело
decision = решение
wide = широкий
agreement = соглашение
kill = убивать
site = место
either = один из двух ; тоже не
various = разнообразный
screw = закручивать
test = тест ; проверять
eat = кушать
close = близкий ; закрывать
represent = представлять
colour = цвет
shop = магазин
benefit = выгода
animal = животное
heart = сердце
election = выборы
purpose = цель
due = обязанный
secretary = секретарь
rise = восход ; подниматься
date = дата ; датировать
hard = упорно ; тяжелый ; упорный
music = музыка
hair = волосы
prepare = приготовить
anyone = кто-нибудь
pattern = модель
manage = управлять
piece = кусок
discuss = обсуждать
prove = доказывать
front = передняя часть ; передний
evening = вечер
royal = королевский
tree = дерево
population = население
fine = прекрасный
plant = растение ; завод ; сажать
pressure = давление
response = ответ
catch = хватать
street = улица
knowledge = знание
despite = несмотря на
design = дизайн ; разрабатывать
kind = вид ; тип ; добрый
page = страница
enjoy = наслаждаться
individual = личный ; частное лицо
rest = остаток ; отдых ; отдыхать
instead = вместо
wear = носить
basis = базис
size = размер
fire = огонь ; пожар ; поджигать
series = ряд ; серия
success = успех
natural = естественный
wrong = неправильный
near = около
round = вокруг ; круглый ; круг
thought = мысль
list = список
argue = спорить
final = окончательный
future = будущее
introduce = знакомить
enter = входить
space = космос ; место
arrive = прибывать
ensure = обеспечивать
statement = утверждение
balcony = балкон
attention = внимание
principle = принцип
pull = тянуть
doctor = доктор
choice = выбор
refer = ссылаться
feature = особенность ; функция
couple = пара
step = шаг ; шагать
following = следующий
thank = благодарить
machine = машина
income = доход
training = тренировка
present = подарок ; дарить ; настоящий
association = ассоциация
film = фильм ; пленка
difference = различие
fucking = проклятый
region = регион
effort = усилие
player = игрок
everyone = каждый
village = деревня
organisation = организация
whatever = что бы ни было
news = новости
nice = замечательный
modern = современный
cell = ячейка ; камера
current = текущий
legal = законный
energy = энергия
finally = окончательно
degree = степень
mile = миля
means = средство
whom = кем
treatment = лечение
sound = звук ; звучать
above = над
task = задание
red = красный
happy = счастливый
behaviour = поведение
identify = распознавать
resource = ресурс ; источник
defence = защита
garden = сад
floor = пол ; этаж
technology = технология
style = стиль
feeling = чувство
science = наука
relate = быть родственным
doubt = сомнение ; сомневаться
ok = хорошо
produce = производить
horse = лошадь
answer = ответ
compare = сравнить
suffer = страдать
forward = вперед
announce = объявлять
user = пользователь
character = персонаж
risk = риск ; рисковать
normal = обычный
myself = я сам
dog = собака
obtain = приобретать
quickly = быстро
army = армия
forget = забывать
ill = больной
station = станция ; участок
glass = стекло ; стакан
cup = кружка
previous = предыдущий
husband = муж
recently = недавно
publish = публиковать
serious = серьезный
anyway = в любом случае
visit = приходить в гости
capital = столица
sock = носок
note = заметка ; отмечать
season = сезон ; время года
argument = спор
listen = слушать
responsibility = ответственность
significant = значительный
deal = некоторое количество ; иметь дело
prime = первичный
economy = экономика
finish = закончить
duty = долг
fight = бой ; драка ; сражаться
train = поезд ; тренировать
maintain = обеспечивать
attempt = попытка
leg = нога
save = беречь
suddenly = вдруг
brother = брат
improve = улучшать
avoid = избегать
teenager = подросток
wonder = хотеть знать ; удивление
fun = забава
title = название
post = почта ; должность
hotel = гостиница
aspect = сторона ; аспект
increase = увеличивать
surname = фамилия
industrial = трудолюбивый
express = выражать
summer = лето
determine = определять
generally = в общем
daughter = дочь
exist = существовать
used to = бывало
share = делить ; акция
baby = дитя
nearly = около
smile = улыбка ; улыбаться
sorry = извини
sea = море
skill = навык
treat = лечить
remove = удалить
concern = забота ; заботиться
university = университет
left = левый
dead = мертвый
discussion = обсуждение
specific = особый
box = ящик
outside = наружный
total = всеобщий
bit = немного
cost = стоимость ; стоить
girlfriend = подружка
market = рынок ; купить или продать на рынке
occur = иметь место
research = исследование ; исследовать
wonderful = чудесный
division = подразделение
throw = выбрасывать
officer = служащий
procedure = процедура
fill = вставлять
king = король
assume = допускать
image = образ
oil = нефть ; масло
obviously = очевидно
unless = до тех пор пока не
appropriate = подходящий
military = военный
proposal = предложение
mention = упоминать
client = клиент
sector = сектор
direction = направление
admit = допускать
basic = основной
instance = пример
sign = знак ; подписывать
original = оригинальный
successful = успешный
reflect = отражать
aware = осознавать
pardon = извините
measure = мера ; измерять
attitude = отношение
yourself = тебя самого
exactly = точно
commission = комиссия
beyond = за пределами
seat = сидение
president = президент
encourage = воодушевлять
addition = дополнение
goal = цель
miss = скучать
popular = популярный
affair = дело
technique = техника
respect = уважение ; уважать
drop = капля ; капать
professional = профессиональный ; профессионал
fly = летать ; муха
version = версия
maybe = может быть
ability = способность
operate = действовать
goods = товар
campaign = кампания
heavy = тяжелый
advice = совет
institution = институт
discover = открывать
surface = поверхность
library = библиотека
pupil = ученик
refuse = отказывать
prevent = предотвращать
tasty = вкусный
dark = темный
teach = учить кого-либо
memory = память
culture = культура
blood = кровь
majority = большинство
answer = отвечать
variety = разнообразие
depend = зависеть
bill = банкнота
competition = соревнование
ready = готовый
access = доступ
hit = ударить ; толчок
stone = камень
useful = полезный
extent = расширение
employment = занятость
regard = внимание ; принимать во внимание
apart = отдельно
besides = кроме того
shit = дерьмо
text = текст
parliament = парламент
recent = недавний
article = статья
object = предмет ; объект
context = контекст
notice = извещение ; заметить
complete = полный ; заполнить
direct = прямой ; управлять
immediately = немедленно
collection = коллекция
card = карточка
interesting = интересный
considerable = значительный
television = телевидение
agency = агентство
except = кроме
physical = физический
check = проверять ; проверка
sun = солнце
possibility = возможность
species = вид
speaker = спикер ; выступающий
second = секунда
laugh = смеяться
weight = вес ; авторитет
responsible = ответственный
document = документ
solution = решение
medical = медицинский
hot = горячий ; жаркий
budget = бюджет
river = река
fit = подходящий
push = толкать
tomorrow = завтра
requirement = требование
cold = холодный ; простуда
opposition = оппозиция
opinion = мнение
drug = наркотик
quarter = четверть ; квартал
option = опция ; вариант
worth = стоящий
define = определять
influence = влияние ; влиять
occasion = случай
software = программное обеспечение
highly = высоко
exchange = обмен
lack = отсутствие ; недостаток ; испытывать недостаток
concept = понятие ; концепция
blue = синий
star = звезда ; играть главную роль
radio = радио
arrangement = приведение в порядок
examine = проверять
bird = птица
busy = занятый ; многолюдный
chair = кресло
green = зеленый
band = музыкальная группа
sex = пол
finger = палец
independent = независимый
equipment = оборудование
north = север
message = послание
afternoon = время после полудня
fear = страх ; бояться
drink = пить ; спиртной напиток
fully = полностью
race = раса ; гонка
strategy = стратегия
extra = дополнительный
scene = сцена
slightly = слегка
kitchen = кухня
arise = подниматься
speech = речь
network = сеть
tea = чай
peace = мир
failure = провал
employee = работник
ahead = вперед
scale = шкала
attend = посещать
hardly = едва
shoulder = плечо
otherwise = по-другому
railway = железная дорога
supply = запас ; снабжать
owner = собственник
associate = общаться
corner = угол
past = прошлый
match = матч ; спичка ; соответствовать
sport = спорт
beautiful = красивый
hang = висеть
marriage = свадьба
civil = гражданский
sentence = предложение
crime = преступление
ball = мяч
marry = жениться
wind = ветер
truth = правда
protect = защищать
safety = сохранность ; надежность
partner = партнер
copy = копия ; копировать
reader = читатель
sister = сестра
below = ниже
trial = судебный процесс
rock = скала
damage = вред  ; вредить
newspaper = газета
meaning = значение
nation = нация
length = длина
south = юг
branch = ветка
deep = глубокий
none = ни один
trust = доверие ; доверять
pain = боль
positive = положительный
spirit = дух
college = колледж
accident = авария
mark = отметка ; отмечать
works = завод
league = лига
imagine = представить себе
cash = наличные деньги
strength = сила
target = цель
travel = путешествие ; путешествовать
pair = пара
gas = газ
male = мужской ; существо мужского пола
contribution = взнос
complex = сложный
artist = художник
agent = агент
farm = ферма
glasses = очки
fund = запас ; фонд
hello = привет
labour = трудовой ; труд
performance = представление
toilet = туалет
presence = присутствие
environmental = относящийся к окружающей среде
contact = контакт ; контактировать
beginning = начало
demand = требовать
media = СМИ
employ = нанимать работника
shoot = стрелять
slowly = медленно
relatively = сравнительно
aid = помощь
speed = скорость
review = обзор
route = маршрут
consequence = последствие
telephone = телефон
proportion = пропорция
primary = начальный
driver = водитель
reform = реформа
annual = годовой
latter = последний из двух
commercial = коммерческий
rich = богатый
ring = звонок ; звонить
distance = дистанция
exercise = упражнение ; осуществлять
key = ключевой ; ключ
skin = кожа
island = остров
separate = отдельный ; отделять
aim = цель ; стремиться
danger = опасность
credit = кредит
usual = обычный
link = связь ; сцеплять
candidate = кандидат
track = трасса ; дорожка
safe = безопасный
interested = заинтересованный
path = путь
plus = плюс
district = район
regular = регулярный
reaction = реакция
collect = собирать
debate = дискуссия
lay = класть ; лежать
belief = вера
conclusion = заключение
shape = форма ; придавать форму
vote = голосовать ; голосование
politics = политика
reply = отвечать ; ответ
press = нажимать
sick = больной
file = файл
western = западный
earth = земля
survive = выживать
boat = судно
prison = тюрьма
additional = дополнительный
settle = селиться
largely = обильно
observe = наблюдать
wine = вино
limit = ограничивать
deny = отрицать
straight = прямой
somebody = кто-то
writer = писатель
clothes = одежда
weekend = конец недели
active = активный
clever = умный
expression = выражение
fast = быстрый
nor = ни
video = видео
reality = реальность
hall = коридор
guess = угадать ; полагать
nevertheless = тем не менее
perfect = совершенный
rain = дождь ; идет дождь
shake = трясти
regional = региональный
vehicle = транспортное средство
worry = беспокоиться
powerful = мощный
possibly = возможно
cross = пересекать ; крест
colleague = коллега
respond = отвечать
employer = работодатель
understanding = понимание
comment = комментарий ; комментировать
connection = связь
concentrate = концентрироваться
ignore = игнорировать
phone = телефон ; звонить по телефону
hole = отверстие
insurance = страхование
content = содержание
confidence = уверенность ; доверие
alone = одинокий
objective = цель
transport = транспорт
flower = цветок
lift = поднимать ; лифт
stick = палка ; наклеивать ; втыкать
mainly = главным образом
battle = битва
generation = поколение
winter = зима
inside = внутри
impossible = невозможный
arrange = подготовить ; уладить
sleep = спать ; сон
progress = прогресс
ship = корабль
volume = том ; громкость
commitment = обязательство
conflict = конфликт
bag = сумка
fresh = свежий
fair = справедливый ; белокурый
promise = обещание ; обещать
introduction = введение
manner = манера
senior = старший
background = фон
touch = прикосновение ; дотронуться
vary = менять
sexual = половой
cabinet = кабинет министров ; шкаф
ordinary = обычный
painting = живопись
engine = двигатель
administration = администрация
tonight = этим вечером
adult = взрослый
prefer = предпочитать
author = автор
actual = действительный
song = песня
debt = долг
forest = лес
visitor = посетитель
repeat = повторить
wood = древесина
contrast = контрастность
carefully = аккуратно
extremely = чрезвычайно
wage = зарплата
domestic = домашний
threat = угроза
bus = автобус
warm = теплый
sir = сэр
range = ряд ; располагать в порядке
replace = замещать
internal = внутренний
excellent = превосходный
strange = странный
fairly = справедливо
technical = технический
tradition = традиция
traffic = дорожное движение
until = до тех пор пока не
dinner = обед ; полдник
meal = прием пищи
warn = предупреждать
award = награда ; награждать
package = пакет
description = описание
soft = мягкий
stuff = чепуха ; материал
clean = чистый ; чистить
ticket = билет
umbrella = зонт
improvement = улучшение
coffee = кофе
appearance = внешность
standard = стандартный ; стандарт
attack = атаковать
sheet = простыня ; лист
category = категория
distribution = распространение
session = занятие
cultural = культурный
dodgy = хитрый ; плутоватый
museum = музей
conversation = разговор
threaten = угрожать
launch = запускать
proper = настоящий ; тщательный
victim = жертва
audience = аудитория
famous = знаменитый
master = мастер
lip = губа
religious = религиозный
joint = совместный
cry = плакать
potential = потенциальный
broad = широкая часть
exhibition = выставка
judge = судить ; судья
formal = формальный
housing = жилье
freedom = свобода
gentleman = джентльмен
attract = привлекать
explanation = объяснение
appoint = назначать
chief = шеф-повар ; главный
lovely = прелестный
official = официальный
demonstrate = демонстрировать
construction = конструкция
middle = средний ; середина
yard = двор
unable = неспособный
acquire = приобретать
crisis = кризис
surely = несомненно
propose = предлагать
west = запад
god = бог
favour = покровительство
equal = равный
flat = плоский ; квартира
selection = выбор
football = футбол
factory = фабрика
circumstance = обстоятельство
contain = содержать
environment = окружающая среда
exam = экзамен
facility = удобства ; легкость
victory = победа
rural = сельский
twice = дважды
sing = петь
deliver = доставлять
nobody = никто
invite = приглашать
substantial = существенный
egg = яйцо
reasonable = обоснованный
airplane = самолет
cheap = дешевый
mum = мама
quiet = спокойный ; тихий
tend = склоняться к
bright = яркий
row = ряд
search = поиск ; искать
definition = определение
unemployment = безработица
spread = распространять
flight = полет ; рейс
tour = тур
address = адрес ; адресовать
immediate = немедленный
interview = интервью ; собеседование ; проводить собеседование
everybody = каждый
growing = растущий
ought = должен
suitable = подходящий
dream = мечта ; сон ; мечтать
fruit = фрукт
divide = разделить
declare = декларировать
detailed = детальный
handle = рукоятка ; брать руками
challenge = вызов ; сложная задача ; оспаривать
destroy = разрушить
mountain = гора
finance = финансы ; финансировать
pension = пенсия
afraid = испуганный
murder = убийство
neck = шея
hide = прятать
weapon = оружие
offence = оскорбление
absent = отсутствующий
error = ошибка
representative = представитель
criticism = критика
average = средний
quick = быстрый
sufficient = достаточный
appointment = назначение
transfer = перемещение ; перемещать
spring = весна
birth = рождение
ear = ухо
recognize = определять
recommend = рекомендовать
instruction = инструкция
democratic = демократичный
park = парк ; парковать
weather = погода
bottle = бутылка
bedroom = спальня
kid = ребенок
pleasure = удовольствие
realize = представить себе
entirely = всецело
expensive = дорогой
extend = расширять
pick = срывать
protection = защита
select = выбирать
desire = желание
whilst = пока
combine = совмещать
temperature = температура
wave = волна
magazine = журнал
totally = абсолютно
mental = умственный
store = магазин ; склад ; снабжать
used = использованный
frequently = часто
scientific = научный
thanks = благодарность
beside = около
absolutely = абсолютно
settlement = поселение
critical = критичный
recognition = опознавание
consist = состоять
silence = молчание
dress = платье ; одевать
dangerous = опасный
familiar = знакомый
sweet = сладкий ; конфета
tomato = помидор ; томатный
belong = принадлежать
educational = образовательный
sum = сумма
partly = частично
publication = публикация
block = блок ; квартал ; блокировать
seriously = серьезно
tape = пленка
youth = молодежь
elsewhere = где-то в другом месте
fee = плата ; взнос
program = программа
treaty = договор
properly = тщательно
unlikely = маловероятно
guest = гость
code = код
factor = фактор
affect = наносить ущерб
hill = холм
household = домашнее хозяйство
screen = экран
sequence = последовательность
correct = правильный ; исправлять
female = женский ; существо женского пола
phase = фаза
daily = ежедневный
goat = козел
holiday = праздник
crowd = толпа
welcome = приветствовать
metal = металл
widely = широко
sky = небо
brain = мозг
expert = эксперт
experiment = эксперимент
tiny = крошечный
disappear = исчезать
photograph = фотография
congress = конгресс
reading = чтение
scientist = ученый
closely = близко
secure = охранять
thin = худой
plate = тарелка
pool = лужа ; бассейн
emphasis = ударение
gold = золото
shout = кричать
location = расположение
display = показ ; проявлять
heat = жара ; нагревать
gun = ружье
shut = закрыть
journey = путешествие
difficulty = трудность
growth = рост
violence = насилие
dry = сухой ; сушить
historical = исторический
lunch = обед
noise = шум
bottom = дно
initial = начальный
theme = тема
characteristic = характеристика
pretty = хорошенький
empty = пустой
combination = сочетание
interpretation = перевод
escape = избегать
score = засчитывать ; счет
upper = верхний
tooth = зуб
cat = кот
organise = организовывать
tool = инструмент
spot = пятно ; пятнать
bridge = мост
double = двойной
conclude = подвести итог
relative = родственный
soldier = солдат
climb = взбираться
breath = дыхание
afford = позволить себе
urban = городской
nurse = няня
narrow = узкий
liberal = либеральный
coal = уголь
priority = приоритет
wild = дикий
membership = членство
approve = одобрять
tall = высокий
faith = вера
fix = фиксировать
slow = медленный
leading = ведущий
component = компонент
bloody = проклятый ; кровавый
literature = литература
conservative = консервативный
variation = изменение
remind = напомнить
inform = информировать
neither = ни ; также не
mass = масса
chemical = химический
careful = заботливый
dad = папа
selfish = эгоистичный
advantage = преимущество
investigate = исследовать
seldom = редко
roll = катить ; вертеть ; рулон
instrument = инструмент
guide = проводник ; гид ; вести
pocket = карман
suggestion = предложение ; совет
tone = тон
attractive = привлекательный
dollar = доллар
farmer = фермер
funny = забавный
lamp = лампа
lucky = счастливый
surprise = сюрприз ; удивление ; удивлять
Christmas = Рождество
madam = мадам
pub = паб
illustrate = иллюстрировать
ride = ехать верхом
foundation = основание
restaurant = ресторан
alternative = альтернатива ; альтернативный
vital = жизненный
burn = гореть ; жечь
map = карта
device = устройство
customer = покупатель
jewellery = драгоценности
jump = прыгать
mail = почта
suppose = полагать
swim = плавать
unite = объединять
estimate = оценивать
conduct = вести
advance = продвижение ; двигать вперед
advise = советовать
east = восток
satisfy = удовлетворять
hell = ад
effectively = эффективно
winner = победитель
mistake = ошибка
incident = происшествие
focus = фокус ; фокусировать
representation = представительство
release = освобождение ; облегчать
border = граница
leaf = лист
wash = мыть
observation = наблюдение
trip = поездка
gather = собирать
ancient = древний
brief = краткий
gate = ворота
elderly = престарелый
overall = всеобщий
circle = круг
rare = редкий
creation = создание
anybody = кто-нибудь
flow = течь ; течение
external = внешний
capable = способный
recover = ремонтировать
shot = глоток спиртного ; выстрел
request = просьба
impression = впечатление
neighbour = сосед
theatre = театр
hurt = доставлять боль
mechanism = механизм
atmosphere = атмосфера
chain = цепь
accompany = сопровождать
earn = зарабатывать
enemy = враг
desk = письменный стол
deputy = депутат
distinction = различие
discipline = дисциплина
strike = забастовка ; ударять
married = женатый ; замужняя
plenty = множество
establishment = учреждение
fashion = мода
milk = молоко
roof = крыша
secondary = средний
tear = слеза ; рвать
increased = увеличенный
welfare = благосостояние
attach = прикреплять
typical = типичный
leadership = лидерство
negotiation = переговоры
count = считать
religion = религия
grey = серый
hence = отсюда
alright = удовлетворительно
fuel = топливо
mine = шахта ; мина ; мой
appeal = призыв ; призывать
servant = слуга
liability = ответственность
conference = конференция
constant = постоянный
disease = болезнь
item = пункт
monthly = ежемесячный
obvious = очевидный
pencil = карандаш
per = за ; в
profit = доход
remarkable = замечательный
hate = ненавидеть
shoe = обувь
expense = расход
vast = обширный
soil = почва
nose = нос
origin = происхождение
lord = лорд
editor = издатель
northern = северный
switch = включать или выключать
channel = канал
bone = кость
severe = свирепый
iron = железо ; утюг
via = через
vision = проницательность ; зрение
trend = тенденция
revolution = революция
terrible = ужасный
knee = колено
steal = украсть
unfortunately = к сожалению
criminal = преступник
signal = сигнал
notion = понятие
academic = академический
lawyer = юрист
outcome = последствие ; выход
strongly = сильно
achievement = достижение
explore = исследовать
surround = окружать
odd = странный
expectation = ожидание
corporate = корпоративный ; общий
prisoner = заключенный
rapidly = скоро
amongst = среди
afterwards = впоследствии
paint = краска ; рисовать красками
citizen = гражданин
permanent = постоянный
weak = слабый
ourselves = мы сами
plastic = пластик
connect = соединять
height = высота
plane = самолет
lesson = урок
shock = шок ; шокировать
originally = первоначально
knock = стучать
negative = негативный
root = корень
inner = внутренний
occupy = занимать
independence = независимость
beauty = красавица
struggle = борьба ; бороться
database = база данных
stress = стресс ; ставить ударение
stretch = растягивать
underground = метро
aunt = тетя
bicycle = велосипед
boyfriend = друг ; парень
calm = спокойный
career = карьера
clearly = ясно
excite = вызывать чувства
lake = озеро
sugar = сахар
pen = ручка
trouble = беспокойство ; беда
completely = полностью
existing = существующий
investment = инвестиция
normally = обычно
passenger = пассажир
relief = облегчение
manufacture = производство
snow = снег ; идет снег
sharp = острый
queen = королева
reference = ссылка
virtually = в сущности
waste = растрата ; трата ; ненужный
contemporary = современный
politician = политик
championship = чемпионат
territory = территория
exception = исключение
thick = толстый
topic = тема
resident = постоянно проживающий
transaction = дело ; сделка
massive = массивный
unique = уникальный
inflation = инфляция
assistance = содействие
suit = костюм ; устраивать
parliamentary = парламентский
unknown = неизвестный
preparation = подготовка
badly = плохо
elect = избирать
moreover = более того
uncle = дядя
tie = лента ; связывать
cancer = рак
champion = чемпион
breakfast = завтрак
licence = лицензия ; удостоверение
minority = меньшинство
appreciate = оценивать
fan = болельщик
accommodation = помещение
democracy = демократия
brown = коричневый
taste = вкус
crown = корона
permit = пропуск ; разрешать
buyer = покупатель
gift = подарок
angry = сердитый
resolution = разрешение ; резолюция
metre = метр
wheel = колесо
tank = танк ; бак
engage = привлекать
alive = живой
inch = дюйм
blame = осуждать
yours = твой
quantity = количество
guilty = виновный
coat = пиджак
eastern = восточный
involvement = вовлеченность ; путаница
tension = напряжение
diet = диета
rarely = редко
prize = приз ; награда
dominate = управлять
glance = быстрый взгляд ; бросить взгляд
advertisement = реклама
naturally = естественно
relevant = уместный
extension = расширение
mix = смешивать
acknowledge = сознавать
friendly = доброжелательный
gain = извлекать выгоду
regime = режим
bike = велосипед
brush = щетка ; чистить
confirm = подтверждать
curious = любопытный
excuse = просить прощения
gender = пол
hungry = голодный
kilometre = километр
chairman = председатель
fish = рыба
grandfather = дедушка
tire = уставать
cent = цент
rice = рис
signature = подпись
translate = переводить
useless = бесполезный
fault = ошибка ; просчет
ugly = безобразный
smart = энергичный ; интенсивный
towel = полотенце
grass = трава
basketball = баскетбол
quietly = спокойно ; тихо
soap = мыло
complain = жаловаться
delivery = доставка
shift = перемещать ; сдвиг
beach = морской берег
port = порт
depth = глубина
grandmother = бабушка
unusual = необычный
obligation = обязательство
pilot = пилот
yellow = желтый
republic = республика
shadow = тень ; затенять
analyse = анализировать
dear = дорогой
anywhere = где-нибудь
long-term = долгосрочный
phrase = фраза
soup = суп
convince = убеждать
trick = обман ; уловка
coast = берег моря
engineer = инженер
heavily = тяжело
glad = рад
charity = благотворительность ; благотворительная организация
oppose = возражать
defend = защищать
arrest = арест ; арестовать
warning = предупреждение
approval = одобрение
bother = беспокойство
novel = роман
currency = валюта
moral = моральный
possess = обладать
distinguish = различие
gently = мягко
reckon = считать
assist = содействовать
justify = оправдывать
behalf = от лица
setting = окружение ; регулировка
command = команда
poem = стихотворение
stair = ступенька
chest = сундук ; грудная клетка
secret = секрет ; секретный
efficient = эффективный
restriction = ограничение
suspect = подозревать ; подозреваемый
hat = шляпа
tough = жесткий ; скандалист
healthy = здоровый
occasionally = время от времени
camp = лагерь
comfortable = комфортабельный
saving = спасительный
partnership = партнерство
wake = просыпаться
composer = композитор
provision = обеспечение
status = статус
weird = жуткий
abroad = за границей
profession = профессия
countryside = сельская местность
boot = ботинок
mostly = главным образом
sudden = внезапный
print = печатать
butter = масло
cinema = кинотеатр
data = данные
emerge = появляться
enormous = громадный
essential = необходимый
huge = гигантский
birthday = день рождения
cook = повар ; готовить
aloud = вслух
amusing = забавный
easily = легко
flour = мука
lady = леди
o'clock = часов
thirsty = томимый жаждой
wisdom = мудрость
calculate = вычислять
keen = стремящийся к
autumn = осень
recommendation = рекомендация
poll = опрос
voluntary = добровольный
valuable = ценный
recovery = возврат
solve = решать
agriculture = сельское хозяйство
laptop = ноутбук
truth = правда
ice = лед
constitution = конституция
layer = слой
dramatic = драматический
golden = золотой
temporary = временный
shortly = коротко
initially = в начале
arrival = прибытие
protest = протест ; возвращать
resistance = сопротивление
presentation = презентация
silent = молчаливый
soul = душа
feed = кормить
self = сам
opposite = напротив
pollution = загрязнение
wealth = богатство
kingdom = королевство
bread = хлеб
perspective = перспектива
camera = фотоаппарат
illness = болезнь
prince = принц
cake = кекс ; пирожное ; торт
meat = мясо
ideal = идеал
relax = расслаблять ; расслабляться
purchase = покупать
beer = пиво
electricity = электричество
monitor = экран ; советовать
federal = федеральный
captain = капитан
boss = хозяин
pour = наливать
creature = создание
urge = подгонять
locate = определять место
being = существо ; существование
valley = долина
guard = охрана
emergency = непредвиденный случай
bomb = бомба
mood = настроение ; наклонение
possession = владение
habit = привычка
gradually = постепенно
expansion = увеличение ; экспансия
competitive = конкурентный
bar = бар ; брусок
criticise = критиковать
potato = картофель
cause = послужить причиной
communication = связь
co-operation = кооперация
cupboard = шкаф для посуды
currently = в настоящее время
gap = брешь
humour = юмор
injury = травма
joy = радость
juice = сок
loss = потеря
nod = покивать
salad = салат
smell = пахнуть ; запах
sofa = дива ; софа
toy = игрушка
acceptable = допустимый
angle = угол
stranger = незнакомец
net = сеть ; трал
sensitive = чувствительный
behave = вести себя
fellow = приятель
honour = честь
Christian = христианин ; христианский
enable = давать возможность
tidy = приводить в порядок
kiss = целовать ; поцелуй
preserve = сохранять ; оберегать
personality = индивидуальность
wedding = свадьба
landscape = ландшафт
lock = замок ; запирать
mirror = зеркало
pure = чистый
symptom = симптом
global = глобальный
aside = в сторону
tendency = тенденция
governor = правитель ; губернатор
pack = пачка ; упаковывать
bean = боб ; фасоль
previously = предварительно
onion = лук
