of=из
to=к
and=и;конъюнкция
in=внутри;расположенный внутри;влияние
his=его;принадлежащий ему
he=мужчина;он
that=тот
you=вы
it=он;идеал
on=относительно;удачный;левая сторона
at=около;собака
with=вместе с;напихать
her=ее
as=когда
for=в течение
this=этот
not=не
said=упомянутый
be=быть;должен
from=из
him=его
she=женщина;она
have=иметь;мошенничество
out=выгонять;внешний;наружу;недостаток
but=но;возражение
would=бы;желание
now=теперь;настоящее время
by=при
into=к
all=весь;вполне;все
they=они
up=вверх;направляющийся в крупный центр;поднимать;подъем
me=меня
your=ваш
are=ар
one=единственный;кто-то;число один
back=подкреплять;спина;задний;назад
them=их
if=ли;неуверенность
no=отрицание;никакой;нисколько не
my=мой
over=над;верхний;излишек
what=что;какой
about=поблизости;двигающийся;менять курс
like=похожий;вероятно;любить;нечто подобное
felt=валять шерсть;войлочный;войлок
only=только;исключительный
down=спуск;опускать;направленный вниз;вниз
their=их
man=мужчина;укомплектовывать личным составом
looked=глядевший
eyes=глаза
more=больше;больший;большее количество
will=воля;проявлять волю;вспомогательный глагол
through=сквозь;прямой;пролезать
know=знать
who=кто
grandfather=дедушка
so=так
we=мы
do=делать;обман;таким же образом
see=видеться;епархия
thought=мышление
keystone=замковый камень
which=какой;который
here=тут;настоящее место
than=как
turned=изготовленный на станке
floor=пол;настилать пол;напольный
there=там
again=снова
toward=происходящий;около
door=дверь;дверной
just=справедливый;именно
when=когда;время
time=время;удачно выбирать время;повременный
still=тишина;неподвижно;успокаиваться;неподвижный
or=желтый цвет;или
where=где;место происшествия
room=комната;жить на квартире
right=справедливо;правый;правильность;исправлять
himself=сам
before=перед
yet=до сих пор
head=голова;возглавлять;передний
key=ключ;запирать на ключ;главный
seemed=казавшийся
left=левая сторона;налево;левый
two=двойка;два
moment=момент;моментный
box=коробка;класть в коробку
off=более удаленный;долой;правая сторона поля;прекращать
made=сделанный
never=ни разу
across=поперек
tell=рассказывать
long=длинный;долго;страстно желать;долгий срок
some=какой-либо;приблизительно
secret=тайный;секрет
something=что-то
us=нас
can=жестяная коробка;быть в состоянии;может
its=его
how=как;метод
most=много;многие;большая часть
then=тогда;тогдашний
any=кто-либо;какой-нибудь
inside=внутренняя часть;внутренний;внутрь
voice=голос;выражать;голосовой
way=путь;далеко
far=далеко;дальний;большое расстояние
police=поддерживать порядок;полиция
found=основывать;найденный;геологоразведка
message=сообщение;посылать сообщение или донесение
phone=телефон;звонить по телефону
even=ровный;выравнивать;точно;вечер
hand=рука;передавать;ручной
first=первое число;сперва;первый
saw=пила;пилить;пильный
tonight=сегодня вечером;сегодняшний вечер
open=открытый;открывать;открытое пространство
away=далеко;отстоящий
own=свой собственный;иметь;собственность;свой
around=вокруг
get=доставать;приплод
behind=после;зад
find=находить;находка
need=надобность;нуждаться
years=возраст
called=называемый
heard=услышанный
much=очень;многое
very=настоящий;очень
call=крик;звать;позывной
another=другой;еще один
world=мир;всемирный
look=смотреть;взгляд
think=думать;размышление
last=последний;продлиться;после всех;конец
face=лицо;стоять лицом
woman=женщина
too=слишком
men=люди
name=имя;называть
tomb=могила;хоронить
our=наш
beneath=внизу
help=помогать;помощь
must=необходимость;должен;быть должным
might=могущество;может быть
stone=камень;побивать камнями;каменный
other=дополнительный;иначе
end=конец;кончать
idea=идея
take=брать;захват
place=место;ставить
looking=смотрящий
night=ночь;ночной
history=история
these=эти
light=светлый;свет;зажигать;налегке
why=причина;почему
words=речь
don't=не;запрет
make=делать;работа
number=число;нумеровать
life=жизнь;пожизненный
front=перед;выход`ить на;передний
car=легковой автомобиль
almost=почти;фактический
should=должен
word=слово;выражать словами
once=один раз;прежний;один раз
well=колодец;хорошо;здоровый;бить ключом
course=курс;охотиться с гончими;курсовой
hidden=спрятанный
line=линия;проводить линию;линейный
being=существование;существующий
small=маленький;узкая тонкая часть
knight=рыцарь;возводить в рыцарское достоинство
nothing=мелочь;совсем нет
realized=реализованный
always=всегда
trying=утомительный
going=работающий;отъезд
truth=правда
body=тело;воплощать
gun=орудие;орудийный;обстреливать артиллерийским огнем
agent=агент;действующий
several=каждый;несколько;некоторое количество
many=многие;много;большинство
three=тройка;три
ago=тому назад;тому назад
painting=живопись;рисующий
side=стенка;быть на чьей-л. стороне;боковой
both=тоже;оба
few=незначительное число;немногие;мало
already=уже
code=кодекс;кодифицировать
church=церковь;церковный
people=народ;населять
moved=сдвинутый
ancient=античный;старейшина
after=потом;последующий
art=искусство;художественный
within=в пределах;внутренняя сторона
pulled=тянутый
sacred=священный
modern=современный;человек нового времени
enough=достаточно;достаточный;достаточное количество
feel=трогать;осязание
symbol=символ
kind=сорт;хороший
little=маленький;немногое;мало
window=окно;оконный
bank=вал;сгребать;банковый
black=черный;черный цвет;окрашивать черной краской
those=те
feet=ноги
anything=что-либо
ever=когда-либо
read=читать;начитанный;чтение
information=информация
until=не раньше
mind=разум;возражать;мягкий
same=тот же самый;одинаковый;тот же
famous=знаменитый
truck=грузовик;перевозить автотранспортом
someone=кто-то
second=секунда;второй;быть секундантом;вторым номером
grandfather's=дедовский
surprised=удивленный;в изумлении
question=спрашивать;вопрос
powerful=сильный
go=идти;ход
without=без
come=приходить
outside=наружная часть;снаружи;наружный
pocket=карман;класть в карман;карманный
enormous=громадный
also=тоже
immediately=тотчас
entire=целый;полнота
known=известный
sense=чувство;чувствовать
good=хороший;польза;хорошо
hands=экипаж
believe=верить
day=день;дневной
certain=определенный;нечто несомненное
reached=достигнутый
smile=улыбка;улыбаться
imagine=воображать
leave=уезжать;разрешение
female=женского пола;женская особь
against=на
wall=бок;обносить стеной;стенной
under=под;нижний;недолет
feeling=ощущение;полный сочувствия
final=последний;решающая игра в матче
hear=слышать
work=работать;работа
home=дом;дома;домашний;возвращаться домой
lost=потерянный
family=семья;семейный
young=молодой;молодежь;молодо
wanted=разыскиваемый
want=хотеть;недостаток
power=сила;силовой;много;снабжать силовым двигателем
true=верный;выверять;правдиво;истина
while=пока;проводить время;промежуток времени
goddess=богиня
deep=глубокий;глубь;вглубь
new=недавнего происхождения;недавно;новое
minutes=протокол
directly=прямо
plane=плоскость;пар`ить;плоский
building=здание;строительный
dark=темный;темнота;темно
reason=причина;размышлять
understand=понимать
large=большой;широко
holding=участок земли
sorry=огорченный
say=говорить;высказывание
anyone=кто-либо
every=каждый;каждый
fact=факт
everything=все самое важное;все
used=использованный
hard=твердый;сильно;брод
story=повесть
coming=будущий;приход
actually=действительно
quickly=быстро
tried=испытанный
thing=вещь
house=дом;предоставлять жилище
account=счет;считать;бухгалтерский
dead=мертвый;умершие;совершенно
sir=сэр;величать господином
closed=закрытый
feminine=женский;женский род
red=красный;красный цвет
keep=держать;прокорм
familiar=близкий;близкий друг
set=вводить;комплект;неподвижный
pagan=неверующий;языческий
better=улучшать;лучший;лучше;держащий пари
blood=кровь;пускать кровь;кровяной
itself=себя
beside=рядом с
table=стол;класть на стол
simply=просто
top=верхушка;снабжать верхушкой;верхний
finally=в конце
kept=содержащийся
five=пятерка;пять
opened=открытый
else=еще
suddenly=внезапно
entrance=вход;вступительный;восхищать
earlier=ранее
later=запоздалый;поздно
heart=сердце
appeared=появившийся
moving=волнующий
altar=алтарь
meaning=значительный;значение
lay=класть;расположение;светский
orb=глухая аркада
however=как бы ни
poem=стихотворение
slowly=медленно
between=между
past=после;прошлый;прошлое
glass=стекло;помещать в парник;стеклянный
sure=уверенный;конечно
pointed=остроконечный
rest=покой;отдыхать
because=потому что
forward=передний;помогать;вперед;нападающий
heavy=тяжелый;тяжелое орудие;сильно
probably=вероятно
male=мужской;мужчина
near=близкий;близко;приближаться
devil=дьявол;надоедать
point=точка;указывать
alone=в одиночестве;один
raised=выращенный
monk=монах
demanded=требуемый
letters=литература
ask=просить
four=четверка;четыре
gate=ворота
book=книга;заносить в книгу;книжный
stop=останавливать;остановка
next=потом;следующий
use=употребление;употреблять
paper=бумага;бумажный;завертывать в бумагу
breath=дыхание
done=сделанный
security=безопасность
taking=захват;заманчивый
seconds=товары второго сорта
apparently=явно
silent=молчаливый;немой фильм
curator=хранитель музея
considered=обдуманный
let=пускать;сдача внаем
standing=сто`ящий;вес в обществе
early=ранний;рано
text=текст;пис`ать крупным почерком
obviously=по-видимому
written=написанный
center=центр;концентрировать
others=другие
chalice=чаша
seat=место;сажать
speak=говорить
fell=рубить;шкура;жестокий
fear=страх;бояться
sounded=прозвучавший
arrived=прибывший
boy=мальчик
sent=посланный
sound=звонить;здоровый;звук;крепко
turn=поворачивать;оборот
days=днем;эпоха
spoke=спица;снабжать спицами
gone=пропащий
instant=немедленный;момент;как только
needed=нужный
empty=опорожнять;порожний;порожняя тара
possibly=возможно
evening=вечер;вечерний
cylinder=цилиндр;цилиндрический
books=сборник отчетов
above=выше;упомянутый выше;вышеупомянутое
hour=час
brotherhood=братство
pentacle=магическая фигура
certainly=конечно
below=внизу
move=двигать;движение
white=белый;белый цвет
it's=это
having=имеющий;обладание
metal=металл;покрывать металлом;металлический
run=бегать;бег
ahead=вперед;предстоящий
old=старый;прошлое
great=большой;сильные мира сего;замечательно
silence=тишина;заставить замолчать
bed=кровать;класть в постель;постельный
lights=светофор
pain=боль;мучить
faith=вера
system=система
given=данный;нечто данное
lid=крышка
driver=водитель
shoulder=плечо;взвалить на плечи
arms=оружие
password=пароль
wide=широкий;широко
become=делаться
put=класть;бросок камня;положенный
give=давать;податливость
less=меньший;меньше;меньшая сумма
protect=защищать
deserted=пустынный
quite=вполне
air=воздух;проветривать;воздушный
each=каждый;каждый
clear=очищать;ясный;ясно;просвет
hallway=коридор
chapel=часовня
revealed=выведенный
staring=широко раскрытый
priest=жрец;посвящать в священники
pilot=лоцман;пробный;вести
decided=определенный
trust=доверие;доверять;доверенный
evidence=основание;свидетельствовать
friend=друг;помогать
unexpected=неожиданный
manuscript=рукописный;рукопись
bring=приносить
important=важный
part=часть;разделять;частью
hangar=ангар
answer=отвечать;ответ
leaving=уход
carried=свезенный
least=наименьший;меньше всего;малейшая степень
sanctuary=храм
private=частный;половые `органы
pyramid=располагать в виде пирамиды;пирамида
cell=камера;помещать в клетку
rather=лучше
belt=пояс;подпоясывать
wooden=деревянный
earth=земля;окучивать
often=часто
hold=держать;трюм
break=ломать;пролом
taxi=ехать на такси;таксомоторный;такси
image=изображение;изображать
hurried=торопливый
lot=жребий;дробить на участки;гораздо
simple=простой;простой человек
ghost=привидение;являться
doing=делание;делающий
captain=капитан;руководить
rose=роза;делать розовым;розовый
women=женщины
treasure=хранить;сокровище
wrong=неправильный;зло;быть несправедливым;неправильно
direction=направление
flesh=тело;разжигать кровожадность
meet=встречать;сбор (собрание);подобающий
stopped=остановившийся
reveal=показывать;разоблачение
limousine=лимузин
turning=поворот;токарный
making=создание;делающий
killed=убитый
location=определение места
tone=тон;придавать желательный тон
along=дальше
speaking=говорящий;разговор
such=таковой;такой
worship=почитание;поклоняться
although=если бы даже
carefully=осторожно
whose=чей
ground=земля;сесть на мель;грунтовой
royal=королевский;член королевской семьи
perfect=совершенствовать;совершенный;перфект
mean=средний;намереваться;середина
rosewood=палисандровое дерево
talking=говорящий
news=новости
doorway=вход в помещение
may=быть вероятным;может;дева
rear=поднимать;тыл;задний
bishop=епископ
obvious=явный
really=действительно
since=с тех пор
cross=пересекать;крест;сердитый;косо
dear=дорогой;милый;дорого
exactly=точно
computer=компьютер;компьютерный
placed=поставленный
matter=вещество;иметь значение
ten=десятка;десять
plan=чертеж;составлять план
force=заставлять;сила
eyed=с глазками
half=половина;наполовину;неполный
forever=навсегда;вечность
quiet=тихий;тишина;успокаивать;тихо
marble=мраморный;мрамор;расписывать под мрамор
hiding=порка
short=короткий;краткость;резко
original=первоначальный;подлинник
verse=стих;пис`ать стихи
continued=непрерывный
murder=убивать;убийство
hall=зал
death=смерть;смертный
watching=смотрящий;надзор
soon=скоро
distance=расстояние;помещать на определенном расстоянии
city=город;городской
vault=свод;покрывать сводом
stairs=лестница
sight=зрение;увидеть
gold=золото;золотой
human=человеческий;человек
year=год
surprise=удивлять;удивление;внезапный
odd=нечетный;нечетное число
finding=находка
waiting=ждущий;ожидание
piece=кусок;комбинировать;штучный
office=контора
buried=похороненный
clearly=конечно
chamber=комната;заключать в камеру;камерный
aimed=прицельный
saying=поговорка
lines=слова роли
running=бегущий;беганье;подряд
hair=волосы;волосяной
knowledge=знание
sign=признак;подписывать
safe=безопасный;сейф
declared=заявленный
case=случай;класть в ящик
area=площадь
died=умерший
arm=рука;вооружать
proof=доказательство;непроницаемый;делать непроницаемым
man's=мужской
uncertain=сомнительный
pressed=уплотненный
watch=наблюдать;часы;вахтенный
quietly=тихо
herself=сама
stay=оставаться;пребывание
soft=мягкий;мягко
card=карта;чесать
bloodline=род
blade=лезвие;клинковый
order=порядок;приказывать
sex=пол;определять пол;половой
embassy=посольство
museum=музей
giving=дарение;дающий
show=показывать;показ;выставочный
search=искать;поиски;поисковый
screen=ширма;защищать
closer=ближе
indeed=в самом деле
six=шестерка;шесть
wait=ждать;ожидание
eye=глаз;пристально разглядывать
public=общественный;народ
morning=утро;утренний
talk=разговаривать;разговор
road=дорога;дорожный
late=опаздывающий;за последнее время
hell=ад
longer=длительный;долее
rain=дождь;литься;дождевой
expression=выражение
knowing=знающий;знание
personal=личный;светская хроника в газете
drawn=вытащенный
darkness=темнота
beyond=вне;загробная жизнь
legend=надпись
womb=матка
mysterious=таинственный
map=карта;чертить карту
strange=незнакомый
radio=радио;передавать по радио
barely=едва
climbed=взобравшийся
forced=принудительный
exit=выход;уходить;выходной
bit=кусок;взнуздывать;укушенный
dot=ставить точки;точка
explain=объяснять
telling=впечатляющий;выбалтывание
exact=точный;настоятельно требовать
nearby=неподалеку;близкий
spiritual=духовный;верующий
nature=природа
involved=сложный
study=изучение;изучать
group=группа;группировать;групповой
forgotten=забытый
entirely=всецело
main=открытое море;основной
today=сегодня;сегодняшний день
spent=потраченный
please=хотеть
armored=броневой
possible=возможный;возможное
pulling=затягивание;тянущий
close=закрывать;конец;закрытый;близко
gaze=пристально глядеть;пристальный взгляд
deeply=глубоко
supposed=мнимый
corridor=коридор
huge=огромный
return=возвращение;возвращаться;обратный
full=наполненный до краев;кроить широко;как раз
ring=кольцо;окружать кольцом
different=различный
symbolism=символизм
service=связь;служебный;обслуживать
sudden=внезапный
seeing=ввиду того, что;в`идение
learned=ученый
lies=брехня
either=любой;любой из двух
visit=навещать;визит
quest=поиск;искать
electronic=электронный
love=любовь;любить;возлюбленный
hollow=пустота;полый;вполне;выдалбливать
guess=догадываться;догадка
religious=религиозный;монах
street=деловой или финансовый центр;уличный
space=протяженность;оставлять промежутки;космический
bottom=низ;приделывать дно;нижний;под
meeting=собрание;встречный
common=общий;общинная земля
object=несуразный человек;целевой;возражать
coincidence=совпадение
fire=огонь;зажигать
suspect=подозревать;подозреваемый;подозреваемый человек
access=доступ;иметь доступ
alarm=тревога;поднимать тревогу;сигнальный
eager=стремящийся
searching=тщательный
spot=покрывать пятнами;пятно;местный
hole=дыра;продырявливать
cold=холодный;холод;достоверно
wood=лес;деревянный;сажать лес
train=ехать поездом;поезд
whether=ли
missing=недостающий;без вести пропавшие
getting=получающий;выемка
seal=тюлень;ставить печать
pointing=указание;указательный
single=единственный;холостяк;определять
expected=предполагаемый
papyrus=папирус
walking=гуляющий;ходьба
taken=взятый
somehow=как-нибудь
inspector=инспектор
slipped=соскользнувший
grandmother=бабушка;баловать
drove=стадо
finished=законченный
possessed=одержимый
though=хотя
except=за исключением;исключать
reach=протягивать;протягивание
massive=массивный
high=высокий;высоко;высшая точка
pistol=пистолет;пистолетный
claim=требование;требовать
realize=осуществлять
listened=слушавший
agents=агентура
station=место;ставить на определенное место;вокзальный
failed=неудачный
murdered=убитый;убитый
cargo=груз;грузовой
safety=безопасность;предохранительный
fully=вполне
somewhere=где-то
hundred=сто;округ
photo=фото;фотографировать
historical=исторический
living=живой;средства к существованию
language=язык;языковой
circle=круг;двигаться по кругу
carry=нести;переноска
structure=структура;структурировать
person=человек
uneasy=неудобный
bore=высверленное отверстие;сверлить
understood=понятый
drawing=протаскивание
residence=проживание
mystery=тайна;таинственный
considering=принимая во внимание
easily=легко
attention=внимание
archway=проход под аркой
rolled=листовой
yes=согласие;да;поддакивать
shock=удар;поражать;ударный
step=шаг;шагать
laid=проложенный
received=полученный
danger=опасность
religion=религия
crossed=скрещенный
startled=пораженный
growing=усиливающийся;рост
mentioned=упомянутый
shot=выстрел;переливчатый;заряжать ружье
reference=ссылка;снабжать текст ссылками
ceiling=потолок
removed=удаленный
union=союз;союзный
pale=кол;бледнеть;бледный
letter=буква;помечать буквами
caught=пойманный
quick=быстрый;быстро;живая изгородь
sequence=последовательность
form=форма;придавать форму
things=вещи
headstone=могильный камень
arrest=арестовывать;арест
cut=резать;порез;срезанный
doubt=сомневаться;сомнение
suspected=подозреваемый
chief=глава;главный
met=встретивший
jacket=куртка;надевать куртку
decision=решение
act=дело;действовать
honor=честь;уважать
south=юг;к югу;южный;двигаться к югу
television=телевидение;телевизионный
inlaid=инкрустированный
working=работа;отведенный для работы
opening=отверстие;начальный
random=сделанный наугад;неопределенность
guard=охрана;охранять;караульный
albino=альбинос
recognized=признанный
included=включенный
locked=запертый
lifted=поднятый
position=местоположение;ставить
thinking=размышление;мыслящий
bullet=пуля
nobody=никому не известный человек;никто
examined=проверенный
orders=духовный сан
warm=греть;теплый;согревание
north=север;к северу;северный;двигаться на север
concern=отношение;касаться
checked=остановленный
bar=кусок;запирать;не считая;брусковый
fast=прочный;прочно;засов;поститься
soul=душа
studied=обдуманный
sounding=издающий звук;промер глубины лотом
view=вид;осматривать
literally=буквально
canvas=холст;закрывать холстом;брезентовый
woman's=бабий
manservant=слуга
together=вместе;тесно связанный
child=ребенок
tiny=очень маленький;маленький ребенок
perhaps=может быть
afraid=испуганный
whom=кого
best=лучше всего;брать верх;лучший
money=деньги
backward=обратный;назад;прошлое
existed=существовавший
parquet=паркет;паркетный;настилать паркет
vinegar=уксус;уксусный
chance=случайность;рискнуть;случайный
aware=сознающий
false=ложный
faint=слабый;слабеть;обморок
series=ряд
carved=резной
rising=повышение;поднимающийся
choice=выбор;отборный
hotel=гостиница
change=перемена;менять;разменный
start=отправляться в путь;начало
hide=прятать;шкура
society=общественный строй
initials=инициалы
bizarre=странный
fifteen=команда игроков в регби;пятнадцать
disbelief=неверие
smiling=улыбчивый
fall=падать;падение
learn=учить
mouth=говорить торжественно;рот
finger=палец;трогать пальцами
sexual=половой
excitement=возбуждение
perfectly=совершенно
pull=тянуть;тяга
weapon=оружие
purpose=цель;иметь целью
ties=узы
yourself=себя
abbey=аббатство
sitting=сидящий;сидение
figure=цифра;изображать (графически)
jaw=болтливость;говорить
authorities=власти
accent=делать ударение;ударение
offered=предложенный
during=в продолжение
pass=идти;проход
beautiful=прекрасный;прекрасное
created=созданный
straight=прямой;по прямой линии;прямизна
stunned=остолбенелый
wheel=колесо;катить
impossible=невозможный;невозможное
guards=гвардейский;гвардия
lame=неубедительный;калечить;тонкая металлическая пластинка
water=мочить;вода;водный
cilice=ткань из волоса
directions=директивы
emerged=возникший
wearing=предназначенный для носки;ношение
truly=правдиво
desk=письменный стол;настольный
grave=серьезный;гравировать;могила
farther=дальше;более отдаленный;содействовать
lying=лживый;ложь
wisdom=мудрость
divine=предсказывать;божественный;богослов
thousand=тысяча;тысяча
officer=чиновник;обеспечивать офицерским составом
foot=нога;надвязывать чулок
listening=слушание;слушающий
further=дальше;более отдаленный;продвигать
gallery=галерея
similar=похожий;двойник
stand=стоять;стойка
discovered=обнаруженный
kill=убивать;добыча (на охоте)
everyone=каждый
writing=писание;писчий
illuminated=освещенный
including=включая;включающий
middle=середина;помещать в середину;средний
broken=сломанный
broke=разоренный
able=способный
shared=коллективный
driveway=проезд
research=исследование;заниматься исследованиями;исследовательский
opposite=находящийся напротив;против;противоположность
cover=покрывать;крышка
carrying=грузоподъемность
built=построенный
offering=предложение;предлагающий
list=список;вносить в список;сделанный из каймы
proper=присущий;изменяемая часть церковной службы
concerned=имеющий отношение
rooms=помещение
traffic=движение;торговать
write=пис`ать
prison=заключать в тюрьму;тюрьма;тюремный
headed=снабженный заголовком
sigh=вздыхать;вздох
member=член
staircase=лестница
asking=спрашивающий;обращение с вопросом
father=отец;порождать
estate=поместье
bonds=связь
couple=соединять;пара
iron=железо;железный;утюжить
sweater=свитер
added=добавленный
machine=машина;подвергать механической обработке;машинный
bloody=окровавленный;очень;окровавить
contact=соприкосновение;быть в контакте;контактный
amazed=изумленный
brass=латунь;латунный;покрывать латунью
secretariat=секретариат
presence=присутствие
sarcophagus=саркофаг
pay=платить;плата;платный
visible=видимый
purple=фиолетовый;пурпурный цвет;окрашивать в пурпурный цвет
engine=машина
experience=опыт;испытывать
calling=призвание;звонящий
astonishing=удивительный
perimeter=периметр;круговой
settled=постоянный
tip=надевать наконечник;конец
filled=заполненный
twenty=двадцатый;двадцать;двадцать
minute=минута;рассчитывать время по минутам;мелкий
trouble=беспокойство;тревожить;аварийный
lone=одинокий
polished=полированный
contents=содержание
granddaughter=внучка
unable=неспособный
chosen=выбранный
scroll=свиток;украшать завитками
addition=прибавление
law=закон;законный
weight=вес;увеличивать вес
spun=спряденный
gotten=полученный
concept=понятие
mirror=зеркало;отражать
arrival=приезд;вновь прибывший
present=преподносить;присутствующий;настоящее время;налицо
million=миллион;миллион
seek=искать
clue=ключ к разгадке;раскрывать
edge=точить;острие
favorite=любимец;любимый
serious=серьезный
corner=угол;загонять в угол;угольный
terminal=конечный слог;конечный
tired=усталый
accident=несчастный случай
scene=место действия
pleased=довольный
cup=чашка;придавать чашевидную форму
lie=лгать;ложь
ought=долг;должен
leaning=склонность
myself=себя
disappeared=исчезнувший
tie=бечевка;связывать
emotion=чувство
device=схема
knelt=коленопреклоненный
sealed=запечатанный
hope=надежда;уповать
influence=влияние;влиять
enter=входить;выход на сцену
robe=халат;надевать
park=разбивать парк;парк
glance=взглянуть;взгляд
means=средство
stark=окоченевший;совершенно
intention=намерение
ritual=обрядовый;ритуал
offer=предлагать;предложение
begin=начинать
shape=форма;придавать форму;профильный
conveyor=транспортер
served=служивший
ear=ухо;колоситься
architectural=архитектурный
jet=гагат;брызгать струей;реактивный
keeping=хранение;хорошо сохраняющийся
touched=слегка помешанный
plans=виды
collection=собирание;коллекционный
surrounded=окруженный
tape=лента;связывать шнуром или тесьмой
nose=нос;нюхать;носовой
pair=располагать парами;пара;парный
narrow=узкий;суживать;узкий проход
kitchen=кухонный;кухня
big=большой;с важным видом
surface=отделывать поверхность;поверхность;поверхностный
hardly=едва
anagram=анаграмма
correct=исправлять;пр`авильный
risk=рисковать;риск
ultimate=последний
base=основа;основной;базировать
chain=цепь;скреплять цепью;цепной
investigation=расследование
panel=панель;обшивать панелями;панельный
situation=ситуация
located=расположенный
scanning=сканирование;сканирующий
waved=волнистый
girl=девочка
wonder=чудо;интересоваться;изумительный
worked=работавший
sort=вид;разбирать
unless=если не
remember=помнить;воспоминание
advanced=выдвинутый вперед
docent=доцент
tweed=твид
courtyard=внутренний двор
awkward=неуклюжий
low=низкий;низко;самый низкий уровень;мычать
overhead=накладные расходы;верхний;вверху
vial=пузырек
problem=проблема;проблемный
level=выравнивать;высота;ровный;вровень
bare=обнаженный;обнажить
cash=наличные деньги;получать деньги по чеку;кассовый
saint=святой;святой
thick=толстый;густо;гуща
beginning=начало;начинающий
follow=следовать;удар накатом
wrapped=завернутый
woods=дрова
silently=молча
note=заметка;замечать
assume=принимать
tea=чай
inches=высота
protected=защищенный
mistake=ошибаться;ошибка
motion=движение;показывать жестом
cruciform=крестообразный
recently=недавно
returned=возвращенный
field=поле;принимать мяч;полевой
direct=направлять;прямой;прямо
racing=состязание в скорости;гоночный
wind=виток;чуять;ветровой
temple=храм;сооружать храм
la=ля
bumper=бампер;изобилующий;поднимать бокал за здоровье
escape=вырваться;бегство;спасательный
giant=великан;громадный
parents=родители
shattered=разбитый
calm=безветренный;штиль;успокаивать
chill=холод;охлаждать;неприятно холодный
request=просьба;просить разрешения или позволения
physical=физический;медосмотр
identity=тождественность;опознавательный
explanation=объяснение
die=умирать;игральная кость
task=задача;задавать работу
picture=картина;изобразить
produced=произведенный
amused=довольный
host=хозяин;принимать гостей
passenger=пассажир
awoke=разбуженный
anywhere=где-нибудь
loved=любимый
green=зеленый;зеленый цвет;делаться зеленым
credit=вера;верить;кредитный
among=среди
drive=вести;езда
release=освобождение;освобождать
official=служебный;чиновник
divan=тахта
admit=признавать
historian=историк
wound=рана;ранить
themselves=себя
suggested=предложенный
confusion=смущение
elevator=грузоподъемник
memory=память
coffee=кофейный;кофе
required=необходимый
blue=синий;синий цвет;окрашивать в синий цвет
master=хозяин;справляться;главный
job=многострадальный человек;работать сдельно;наемный
grateful=благодарный
servant=слуга;служащий
flight=полет;совершать перелет;полетный
strong=сильный;здоровые;сильно
discuss=обсуждать
shaft=древко
crime=преступление;карать за нарушение устава
deeper=более глубокий
skeptical=скептический
that's=то есть
privacy=уединение
complete=заканчивать;законченный;совершенно
path=тропинка
taught=тугой
recognize=узнавать
bound=отскакивать;обязанный;прыжок
sun=солнце;греть на солнце
political=политический;политзаключенный
invisible=невидимый;невидимый человек
spread=насып`ать;распространение;распространенный
passing=мимолетный;прохождение;очень
gunpoint=дуло пистолета
calmly=спокойно
stolen=краденый
lower=хмурый вид;низкий;спускать;ниже
upon=во время
board=доска;настилать пол
vellum=тонкий пергамент;веленевый
shall=модальный глагол
term=определенный период;выражать
dawn=рассветать;рассвет
downward=спускающийся;вниз
reputation=репутация
seated=сидящий
opportunity=удобный случай
share=делить;доля
guilty=виновный
seem=казаться
intercom=внутренняя селекторная связь
conversation=разговор
broad=широкий;широко;широкая часть
managed=регулируемый
glistening=блестящий
airport=аэропорт
sole=подошва;единственный;ставить подметку
planned=плановый
sleep=спать;сон
landing=высадка;посадочный
using=использование
fit=соответствовать;пригонка;годный;впору
amazement=изумление
revolver=револьвер
forth=вперед
men's=мужской
allowed=допущенный
traced=вычерченный
hostage=залог
games=соревнования
fertility=плодородие
especially=особенно
windows=очи
library=библиотека;библиотечный
yelled=скандируемый
threat=угроза
section=секция;делить на части
we're=мы есть
post=столб;вывешивать;на почтовых;почтовый
fearful=ужасный
catch=поймать;поимка
numerous=многочисленный
silhouette=изображать в виде силуэта;силуэт
mention=упоминание;упоминать
garden=сад;садовый;возделывать
rage=ярость;неистовствовать
respect=уважение;уважать
visitor=посетитель
covered=крытый
beauty=красота
basement=основание
fruit=плод;фруктовый;плодоносить
pressure=давление
coat=пиджак;покрывать
slip=скольжение;скользить
lobby=передняя
birthday=день рождения
control=управление;управлять;управляющий
action=действие;боевой
closely=близко
handle=обращаться;ручка
fired=уволенный
date=дата;датировать
triangular=треугольный
dying=предсмертный;умирание
fundamental=основной;основное правило
horror=отвращение
tradition=традиция
preferred=привилегированный
critical=критический
bars=тюремная решетка
total=весь;подсчитывать;целое
substitution=замена
free=свободный;освобождать;бесплатно;выходной
fresco=фреска;украшать фресками
whisper=шептать;шепот
west=запад;к западу;западный
circular=круглый;циркуляр
star=звезда;украшать звездами;звездный
rise=возвышенность;восходить
emergency=непредвиденный;непредвиденный случай
ordered=упорядоченный
podium=подиум
button=кнопка;застегивать на пуговицы;кнопочный
instinct=инстинкт;жизненный
instantly=тотчас
vaulted=сводчатый
team=команда;объединяться в команду;командный
clean=чистый;чистить;совершенно;чистка
comfortable=удобный;стеганое ватное одеяло
tile=черепица;крыть черепицей или кафелем
symbolic=символический
worthy=достойный;тип
printout=распечатка
cloak=плащ;покрывать плащом
briefcase=портфель
wish=желание;желать
neck=шея;обниматься
charge=нагрузка;нагружать
include=включать
destroy=разрушать
class=класс;классифицировать;классовый
whispering=шепот;шепчущий
unlikely=неправдоподобный;вряд ли
chair=стул;ставить во главе
alive=живой;заживо
steal=воровать;кража
maybe=может быть
tracking=рельсовые пути;следящий
media=средства массовой информации
dubious=сомнительный
eternity=вечность
editor=редактор
frame=каркас;создавать;рамочный
effort=усилие
state=состояние;гласить;государственный
academic=университетский;преподаватель
heading=заглавие;ведущий
solution=растворение
tore=цветоложе
send=посылать
gray=серый;серый цвет;делать серым
sharp=острый;жулик;точно;плутовать
interest=интерес;интересовать
starting=начальный этап;пусковой
weary=утомленный;утомлять
stranger=незнакомец
photograph=фотографировать;фотографический снимок
corpse=труп
lap=колени;завертывать
mathematical=математический
arriving=прибывающий
serve=служить;подача
riddle=говорить загадками;загадка
symbology=символика
works=завод
lowered=сниженный
guest=гость;принимать как гостя;гостевой
closing=закрытие;заключительный
breathe=дышать
modest=скромный
surveillance=надзор
prayer=молитва
lead=свинец;свинцевать;свинцовый
secrecy=секретность
hint=намек;намекать
lecture=доклад;читать лекцию
killing=смертельный;убийство
major=больший;майор;специализироваться по какому-л. предмету
typed=набранный
game=игра;игровой;играть в азартные игры
picked=отборный
wave=развеваться;волна;волновой
anticipation=ожидание
necessary=необходимый;необходимое
nod=кивать головой;кивок
ready=готовый;наличные деньги;готовить;наготове
pen=перо;пис`ать
crowd=толпиться;толпа
bewilderment=смущение
gear=механизм;снабжать приводом
delicate=утонченный;деликатес
listen=слушать
hanging=вешание;висячий
disk=диск;дисковый;дисковать
alphabet=алфавит
driver's=водительский
bedroom=спальня
god=бог;боготворить
oldest=прежний
dial=циферблат;измерять по шкале
confirmed=хронический
marriage=брак;брачный
apart=в отдалении
ruins=развалины
architecture=архитектура
primary=первоначальный;что-либо, имеющее первостепенное значение
innocent=невинный;невинный младенец
none=никто
honored=уважаемый
instead=взамен
throat=горло;бормотать
hit=ударять;толчок
disappointed=разочарованный
reaction=реакция;реактивный
drop=капать;капля
steps=звук шагов
requested=запрошенный
confused=смущенный
tunnel=тоннель;прокладывать тоннель
manager=управляющий
promise=обещать;обещание
burst=взрываться;взрыв
walk=ходьба;ходить
entry=вход;входной
process=процесс;возбуждать процесс
magic=волшебный;магия
remaining=остальной
stomach=желудок;быть в состоянии съесть
response=ответ
ladder=лестница;спускаться
upward=вверх;движущийся вверх
despite=вопреки;злоба
nodding=кивание
topic=тема;местный
literal=буквенный;опечатка
specific=особый;специальное средство
birth=рождение
trusted=доверенный
aura=легкое дуновение
marked=отмеченный
virtually=фактически
pictured=нарисованный
obelisk=обелиск
attempt=попытка;пытаться
usual=обыкновенный;то, что обычно принято
save=спасать;кроме;остановка шайбы вратарем (хоккей)
gathering=собирание;собирающий
properly=должным образом
designed=соответствующий плану
possibility=возможность
troubling=беспокоящий
millennium=тысячелетие
sending=подача сигналов
brother=брат
title=заглавие;давать заглавие;заглавный
business=дело;деловой
aligned=выровненный
real=действительный;очень;действительность
approaching=наступающий
cards=карты
afternoon=время после полудня;после полудня
school=школа;обуздывать;школьный
shaking=покачивание;дрожательный
onboard=бортовой
pretty=прелестный;довольно;хорошенькая вещица
barrel=бочка;разливать по бочонкам
drink=питье;пить
cost=цена;стоить
complex=осложнять;сложный;комплекс
bold=храбрый
dream=видеть сны;сон
clip=зажимать;зажим
helping=помощь;помогающий
sadness=печаль
outstretched=протянутый (о руке)
eventually=в конечном счете
connection=связь
foyer=фойе
chest=ящик;грудной
monsieur=месье
atop=наверху
higher=верхний
character=характер;характеризовать
palm=пальма;прятать в руке
busy=занятой;заниматься
easy=легкий;покойно
data=данные
welcome=радушный прием;приветствовать;желанный
belief=вера
facade=фасад
ancients=древние
promised=обещанный
elaborate=детально разработанный;детально разрабатывать
backing=поддержка
balance=весы;балансировать;балансовый
respond=отвечать;отклик
examiner=экзаменатор
unfortunate=несчастный;неудачник
mission=миссия;посылать с поручением;миссионерский
speechless=немой
happy=счастливый
plenty=изобилие;вполне;обильный
decipher=расшифровывать;расшифровка
property=собственность;имущественный
ensure=застраховать
inserted=вставленный
intersection=пересечение
raising=выведение;повышающийся
firm=твердый;укреплять;фирма;крепко
play=играть;игра
spoken=устный
proven=доказанный
speed=скорость;спешить
intent=внимательный;намерение
land=высаживать;земля;земельный
soap=мыло;мылить
recent=недавний
due=должный;точно;должное
secretly=тайно
military=войска;военный
care=забота;заботиться
paint=красить;краска
fifty=пятьдесят;пятьдесят
signal=сигнал;замечательный;давать сигнал
glad=довольный;гладиолус
mother=относиться по-матерински;мать
telephone=телефонировать;телефонный;телефон
guilt=вин`а
laugh=смеяться;смех
lived=живший
current=текущий;течение
lettered=начитанный
facing=облицовка;облицовочный;принимая во внимание
leg=нога;шагать
marker=маркер
assured=уверенный
utterly=крайне
understanding=понимание;понимающий
definitely=определенно
barn=амбар
agreed=согласованный
worse=хуже;худший;худшее
focus=собирать в фокусе;фокус
vaguely=неясно
twelve=двенадцать апостолов;двенадцать
viewing=рассматривание
divinity=божественность
glow=жар;накаляться докрасна
urgent=срочный
greatest=величайший
science=наука;научный
audio=звуковой;звукозапись
rotary=вращательный;печатная машина
eerie=жуткий
everywhere=всюду
slide=скольжение;скользить
vision=зрение
warrant=ордер;оправдывать
caller=гость;прохладный
drawer=буфетчик
knee=колено;ударить коленом
cabin=хижина;помещать
armor=броня;покрывать броней
lineage=построчная оплата
stuck=застрявший
charges=расходы
solved=решенный
communion=общность
wine=вино;пить вино;винный
command=приказывать;приказ;командный
son=сын
shaken=дрожащий
happen=случаться
live=жить;живой;непосредственно
remain=оставаться;остаток
responsibility=ответственность
anger=гнев;сердить
noted=знаменитый
popular=народный
valuable=ценный;ценные вещи
steel=сталь;покрывать сталью;стальной
shown=указанный
fine=ясный;штрафовать;прекрасно;штраф
prominent=выступающий
vast=обширный;простор
exceptionally=исключительно
thin=тонкий;делать тонким;тонко
usually=обычно
crate=упаковочная клеть;упаковывать в клети
wet=мокрый;влажность;мочить
awake=будить;бодрствующий
shoot=стрелять;охота
lock=локон;запирать
equally=поровну
provided=обеспеченный;при условии
flat=плоский;плоскость;плоско;делать плоским
embarrassment=смущение
intended=суженый;суженый
third=третье число;третий;третьим классом
future=будущее;будущий
dock=ставить судно в док;док
newspaper=газетный;газета
surge=вздыматься;большая волна
traditional=традиционный
points=экстерьер
cassock=ряса
golden=золотой
needs=непременно;потребности
heaven=небеса
desperation=безрассудство
choose=выбирать
threatened=находящийся под угрозой
forehead=лоб
destination=место назначения
impressive=впечатляющий
secure=обеспечивать безопасность;спокойный
warn=предупреждать
decade=группа из десяти
creating=создающий
spreading=распространение;развесистый
walkie-talkie=переносная рация
nowhere=нигде
ramp=скат;идти под уклон
driving=вождение;движущий
fun=веселье;шутить
attack=нападать;нападение;нападающий
natural=естественный;кретин
corporal=телесный;антиминс
weak=слабый;слабоумный
assumed=притворный
seven=семерка;семь
surprisingly=удивительно
following=следующий;последователи;после
performed=выполненный
cap=кепка;вставлять капсюль
trembling=дрожь;дрожательный
nor=и ... не
liquid=жидкий;жидкость
bewildered=смущенный
blinking=мигающий;моргание
pleasant=приятный
mortification=подавление
gas=газ;отравлять газом;газовый
fog=густой туман;окутывать туманом;туманный
surprising=удивительный
mile=миля
according=следовательно
figured=узорчатый
cryptographer=шифровальщик
lift=поднятие;поднимать;подъемный
wheeled=колесный
special=особый;экстренный выпуск;особенно
university=университет;университетский
particular=особый;частность
protection=защита
hunt=охота;охотиться
there's=имеется
receiver=получатель
page=страница;нумеровать страницы
version=вариант;переводить (на другой язык)
flowing=текущий;течение
lose=терять
successfully=успешно
countless=бесчисленный
daily=ежедневный;ежедневная газета;ежедневно
thigh=бедро
cool=прохладный;студить;прохладно;прохлада
founded=основанный
aiming=прицеливание;прицельный
tribute=дань
block=чурбан;преграждать
president=председатель
schedule=список;составлять
interior=внутренность;внутренний
exchanged=обменянный
fault=недостаток;придираться
dash=стремительное движение;бросаться
threatening=угрожающий
crutch=костыль больного
wrath=гнев
twisted=сплетенный
emerging=появление
rare=редкий;исключительно;гренки с сыром
asleep=спящий
guided=управляемый
touch=касаться;прикосновение;чуточку
anonymous=анонимный
particularly=очень
concierge=консьерж
miss=промахиваться;промах
size=размер;разделять по величине
remove=передвигать;ступень
artwork=произведение искусства
director=член правления
stake=кол;обозначать пределы
extracted=добытый
mystical=мистический
born=рожденный
forbidden=запрещенный
address=адрес;адресовать;адресный
operation=действие
previous=предыдущий
flask=фляжка
recover=получать обратно
sake=сакэ (японская водка)
stairwell=лестничная клетка
tipped=наваренный
luck=судьба;быть везучим
enforcement=давление
reading=чтение
cryptic=скрытый
central=центральный;центральная телефонная станция
desperate=отчаянный
safely=благополучно
sliding=скользящий;заслонка
week=неделя
attacker=атакующий
blessed=благословенный
softly=мягко
aim=стремиться;цель
staggering=неустойчивый;нетвердая походка
controller=контролер
complicated=сложный
duty=долг;официальный
shimmering=мерцающий
crypt=склеп
example=образец;служить примером
precisely=точно
breeze=легкий ветерок;веять
threshold=порог
joke=анекдот;шутить
route=маршрут;направлять по определенному маршруту;наголову
recording=регистрация;пишущий
sum=сущность;складывать
lit=освещенный;литерал
alert=бдительный;объявлять тревогу;тревога
euro=евро
larger=больший;больше
grate=тереть на терке;решетка
choir=хор;петь хором
medieval=средневековый
dialed=набранный (о номере телефона)
upstairs=наверху;верхний этаж;находящийся в верхнем этаже
entering=входящий
tree=дерево;загнать на дерево
support=поддержка;поддерживать
tied=связанный
highest=наивысший
underneath=внизу;расположенный ниже;нижняя часть
role=роль
capable=способный
puzzle=вопрос, ставящий в тупик;озадачивать
arranged=урегулированный
accepted=принятый
favor=благосклонность;благоволить
convinced=убежденный
picking=собирание
inward=внутренний;внутрь;внутренняя сторона
holy=святой;святыня
suit=костюм;удовлетворять требованиям
strained=натянутый
war=воевать;война;военный
trip=идти быстро и легко;поездка
associated=объединенный
standard=знамя;нормальный
stole=палантин
nervous=нервный
apparent=видимый
crimson=окрашивать в малиновый цвет;малиновый;малиновый цвет
edifice=здание
try=пытаться;попытка
bluff=отвесный;отвесный берег;обманывать
contain=содержать
dragging=тянущий;волочение
protective=защитный
okay=исправный;хорошо;одобрение;одобрять
actions=поведение
seemingly=судя по виду
press=жать;надавливание
traveled=проезжий
prove=доказывать
bathroom=ванная
tourist=туристический;турист
target=мишень;пристреливать;плановый
survived=переживший
miles=намного
clarity=чистота
stretch=растягивать;вытягивание
brilliant=блестящий;бриллиант
annex=пристройка;присоединять
cipher=нуль;вычислять
pray=молиться;молитва
dozen=дюжина
vehicle=перевозочное средство;транспортировать
strip=резать на ленты;длинный узкий кусок
aside=прочь
laughing=смешной
ears=ушки
wild=дикий;как попало
numeric=числовой;число
gesture=жест;жестикулировать
reverse=менять;противоположное;обратный;противоположным образом
delivered=доставленный
exchange=обмен;менять;обменный
apple=яблоко;яблочный
sin=грех;грешить
additional=дополнительный
baby=крошка;детский;баловать
endure=вынос`ить
initial=начальный;начальная буква;ставить инициалы
warmth=тепло
matrix=матка
logical=логический
regarding=относительно
issue=издание;выпускать
heavily=тяжело
beam=луч;испускать лучи
flash=вспыхивать;вспышка
model=модель;создавать модель;образцовый
sketch=эскиз;делать наброски
organization=организация;организационный
dangerous=опасный
nine=девятка;девять
shiver=дрожь;дрожать
blank=чистый;пустое место;прикрывать
braces=подтяжки
intend=намереваться;намеренно
subject=подчинять;предмет;подчиненный
panic=паника;пугать;панический
anticipated=ожидаемый
sweat=потеть;пот
balcony=балкон;балконный
skin=кожа;сдирать кожу или шкуру;накожный
fireplace=кузнечный горн
glowing=накаленный;накаливание
pathway=тропа
echoing=гулкий
yours=ваш
gently=мягко
source=верховье
uncovered=открытый
compartment=купе
grasped=схваченный
banished=изгнанный
century=столетие
crucifixion=распятие на кресте
clergy=духовенство
children=дети
avoid=избегать;избежание
greater=большой
link=связующее звено;соединять
contrary=противоположный;против;нечто противоположное
troubled=беспокойный
world's=всемирный
sleeve=рукав
based=основывающийся
mortal=смертный;смертный
momentarily=на мгновение
falling=падение;падающий
strength=сила
whole=целый;целое
ringing=вызов;звонкий
ink=чернила;метить чернилами
parking=автомобильная стоянка
confidence=доверие
artistic=артистический
portable=портативный;портативная пишущая машинка
grown=взрослый
status=общественное положение
colossal=колоссальный
extremely=крайне
worried=озабоченный
accept=принимать
reverence=почтение;уважать
killer=убийца
inlay=инкрустация;покрывать мозаикой
audience=зрители
oak=дуб;дубовый
design=замысел;замышлять
princess=принцесса
flower=цветок;цвести
pick=выбирать;кирка
thirty=тридцать;тридцать
cult=культ
protest=протестовать;протест
cab=такси;ехать в такси
downstairs=нижняя часть здания;расположенный в нижнем этаже;вниз
relief=облегчение;запасной
registered=зарегистрированный
appreciate=ценить
octagonal=восьмиугольный
badly=плохо;больной
cognac=коньяк
rectangular=прямоугольный
banker=банкир
entryway=лестничная площадка
excitedly=азартно
shadow=затенять;тень
month=месяц
terrified=запуганный
intriguing=интригующий
endless=бесконечный
fate=судьба;предопределять
announced=объявленный
neither=никакой;также не
meridian=меридиан;полуденный
eight=восьмерка;восемь
dispatcher=диспетчер
guiding=путеводный
forest=лес;лесной;засаживать лесом
yelling=вопящий
shining=блестящий;сияние
descending=опускающийся
article=предмет;предъявлять пункты обвинения
wear=быть одетым в;ношение
blocking=блокирующий;блокировка
bag=мешок;класть в мешок;мешочный
gift=подарок;дарить
apartment=апартамент
gathered=собранный
awkwardly=неуклюже
identify=отождествлять
ornate=богато украшенный
authority=власть
pounded=толченый
option=выбор
repeated=повторный
noticed=замеченный
rough=неровный;неровное поле;делать грубым;грубо
dressed=одетый
glaring=яркий
circumstances=обстоятельства
astrological=астрологический
plastic=пластичный;пластмасса
pas=первенство
intricate=усложнять;сложный
uneasiness=неудобство
anxious=беспокоящийся
bad=плохой;несчастье;дурно
throughout=через
equal=одинаковый;равняться;ровня
terms=гонорар
placing=размещение
features=черты лица
scenario=сценарий
thieves'=воровской
monitor=староста класса;наставлять
revelation=открытие
setting=оправа
void=пустой;пустота;аннулировать
lighting=освещение;осветительный
muted=приглушенный
duct=проток
wary=осторожный
automatically=автоматически
we'll=мы будем
broadcast=передавать по радио;радиовещательный;радиовещание
crucifix=распятие
reflection=отражение
wanting=отсутствующий;без
arrive=прибывать
international=международный;участник международных спортивных состязаний
hearing=слух;слышащий
underground=подпольная организация;под землей;подземный
pause=пауза;делать паузу
fallen=упавший;павшие
established=установленный
clef=ключ
methods=методика
puzzled=недоуменный
trick=хитрость;обманывать;обманчивый
lore=знания
metaphor=метафора
evil=злой;зло
divide=делить;водораздел
community=община;общественный
passion=страсть;выражать страсть
halfway=на полпути;лежащий на полпути
desperately=в отчаянии
buy=покупать;покупка
adjacent=смежный
granted=позволено;предоставленный
curious=любознательный
sea=море;морской
career=карьера;нестись
retrieve=брать обратно
staff=посох;штатный;укомплектовывать штаты
script=почерк;пис`ать сценарий
sacrifice=жертва;жертвовать
leather=кожа (выделанная);крыть кожей;кожаный
pew=церковная скамья со спинкой
globe=ком;делать круглым
relationship=взаимоотношение
newly=заново
subterranean=подземный;подземелье
check=препятствие;останавливать;контрольный
freedom=свобода
roof=крыша;крыть крышу
embedded=включенный
welcoming=приветственный
provide=снабжать
armed=вооруженный
frightening=пугающий
brow=бровь
identical=тот же самый
pentameter=пентаметр
overwhelmed=ошеломленный
quality=качество;высококачественный
shame=стыд;стыдить
pained=страдальческий
mist=туман;застилать туманом
iconography=иконография
repeatedly=неоднократно
terrible=страшный
arched=арочный
firmly=крепко
culture=сельскохозяйственная культура;выращивать
responsible=ответственный
examining=изучающий
confirm=подтверждать
fleeting=быстрый
prefer=предпочитать;предпочтительный
sleeping=спящий;сон
accelerated=ускоренный
controversial=спорный
shooting=стрельба
beg=просить
pardon=прощать;прощение
challenge=вызывать;вызов
tower=башня;выситься;башенный
square=квадратный;придавать квадратную форму;квадрат;прямо
sky=небо;вешать под потолок
grass=трава;засевать травой;подножный
plaza=площадь
idling=работа на холостом ходу;простаивающий
slow=медленный;замедлять;медленно;копуша
sped=ускорившийся
mass=месса;собирать в кучу;массовый
east=к востоку;восток;восточный
right-hand=правый
conclusion=окончание
leap=скакать;прыжок
whatever=что бы ни;какой бы ни
incredulous=недоверчивый
damp=смачивать;сырость;влажный
inspired=вдохновленный
headquarters=штаб
longitude=долгота
confession=признание
struggling=борющийся
librarian=библиотекарь
company=фирменный;компания
affixed=прикрепленный
identification=отождествление
erase=стирать
wire=связывать проволокой;проволока;проволочный
interesting=интересный
twice=дважды
poor=бедный;бедные
vertical=вертикаль;вертикальный
copy=снимать копию;экземпляр
odds=шансы
battle=битва;боевой;бороться
bones=домино
gilded=позолоченный
ceremony=церемония
astronomical=астрономический
records=документация
shouting=возгласы одобрения
numerary=численный
unusual=необыкновенный
younger=младший
couch=ложиться;кушетка
notice=извещение;замечать
fairly=честно
traveling=дорожный;путешествие
mechanism=механизм
ill=больной;плохо;зло
breaking=поломка
warden=смотритель
separated=разделенный
frightened=испуганный
sting=жало;жалить
king=дамка;править
singing=пение
blankly=безучастно
aloud=вслух
dust=пыль;вытирать пыль
judgment=приговор
mere=простой;озеро
masterpiece=шедевр
explosive=взрывчатый;взрывчатка
planet=планета
advantage=плюс;давать преимущество
oath=клятва;давать клятву
container=вместилище
luggage=багаж;багажный
tenth=десятое число;десятый;десятый
kids=лайковые перчатки
barricade=баррикада;баррикадировать
maneuver=маневренный;проводить маневры;маневр
intuition=интуиция
blocked=замороженный
solid=твердый;твердое тело;единогласно
represented=представленный
darkened=потемневший
masculine=мужской;мужской род
trained=выученный
tall=высокий;хвастливо
pillar=столб;подпирать
transport=транспорт;транспортный;перевозить
precision=точность;точный
claw=коготь;царапать
round=круглый;шар;кругом;округлять
spelling=произнесение слова по буквам
record=запись;записывать;рекордный
suggest=предлагать
matched=пригнанный
vocabulary=словник;словарный
antique=памятник древности;древний
womanhood=женская зрелость
rich=богатый;богатые
require=требовать
apply=обращаться
alcove=альков
rubbing=трение
stern=суровый;корма;табанить
unsettling=тревожащий
escaped=беглый
playing=игральный
background=задний план
torture=пытка;пытать
disappear=исчезать
industrial=промышленный;промышленник
legal=юридический
unveil=снимать покрывало
bedside=прикроватный;место у кровати
possession=владение
painted=окрашенный
outward=внешний;наружу;внешний вид
wrist=запястье;наручный
clothing=одежда
sweating=потеющий;потение
oddly=странно
trigger=собачка;спускать курок
grim=жестокий
distant=отдаленный
sit=сидеть
adorned=украшенный
smash=разбивать;грохот;успешный;вдребезги
adjusted=урегулированный
extended=протянутый
doll=кукла;наряжать
lavish=щедрый;быть щедрым
luxurious=роскошный
guarded=охраняемый
fixed=неподвижный
thirteen=тринадцать;тринадцать
speculation=рассмотрение
test=испытание;подвергать испытанию;испытательный
hesitate=колебаться
pride=гордость;гордиться
miniature=миниатюра;миниатюрный;изображать в миниатюре
combination=сочетание
apprehension=опасение
formed=сформировавшийся
client=клиент
spring=скакать;прыжок;весенний
ability=способность
poured=налитый
celebrate=праздновать
exist=быть
enclosed=закрытый
porch=подъезд
appear=появляться
excited=возбужденный
apologize=извиняться
translation=перевод (о языке)
longing=сильно желающий;страстное желание
focused=фокусированный
collected=собранный
shortly=вскоре
local=местный;местная организация
mistakenly=ошибочно
legacy=наследство
legendary=легендарный;сборник легенд
anyway=так или иначе
astonishment=удивление
tablet=дощечка;прикреплять табличку
array=строй;выстраивать
conservative=консервативный;член консервативной партии
divider=делитель
afford=иметь возможность
tracing=прослеживание;трассирующий
willing=готовый
relics=останки
checking=контрольный
totally=абсолютно
brain=головной мозг;размозжить голову
angle=угол;искажать;угловой
breathtaking=поразительный
rudimentary=элементарный
wealthy=богатый;богачи
glasses=очки
studying=изучающий;изучение
sealing=уплотнение
attacked=атакованный
interests=заинтересованные лица
connected=связанный
via=через
operator=оператор
dollars=богатство
worth=ценность;ст`оящий
documentation=документация
eleven=команда из одиннадцати человек;одиннадцать
cryptology=криптология
theory=теория
dramatic=драматический
humor=юмор;потакать
database=база данных
encoded=зашифрованный
premise=посылка;предпосылать
diplomatic=дипломатический
forget=забывать
committed=идейный
newest=новейший
butler=дворецкий
hurry=торопить;спешка
ballroom=бальный;танцевальный зал
strangely=странно
ordinary=дежурное блюдо;обычный
barren=бесплодный;бесплодная земля
dug=раскопанный;вымя
uncertainty=неуверенность
practically=практически
accompanied=сопровождаемый
sensation=ощущение
grotto=грот
smooth=гладкий;приглаживать;гладко;гладкая поверхность
engaged=обрученный;занято
conspiracy=заговор
likely=вероятный;вероятно
hot=горячий;разогревать;горячо;пустая болтовня
core=сердцевина;вырез`ать сердцевину
agree=соглашаться
foreign=иностранный
subtle=тонкий
shower=осыпать;ливень
aisle=придел
match=подходить под пару;спичка;спичечный
ease=облегчать;непринужденность
rumored=известный по слухам
forgive=прощать
steady=прочный;укреплять;возлюбленная;устойчиво
smell=обонять;обоняние
row=ряд;ставить в ряд
lawn=лужайка
trance=состояние экстаза;приходить в экстаз
showing=показатели;проявляющий
loss=потеря
safe deposit=хранилище
attached=прикрепленный
document=документ;снабжать документами
arts=гуманитарные науки
thud=свалиться;глухой звук
crushing=сокрушительный;дробление
rumble=громыхание;громыхать
measure=измерять;мера
fitting=примерка;подходящий
sheet=простыня;покрывать;листовой
anguish=м`ука;испытывать острую тоску
involvement=запутанность
forcing=насилие
winding=извилина;извилистый
permitted=дозволенный
dropping=сбрасывающий;сброс
hum=жужжание;жужжать
fresh=натуральный;прохлада;недавно;свежеть
curb=подгубный ремень;взнуздать;мундштучный
maintenance=поддержание;ремонтный
chaos=хаос
attend=посещать
prepared=готовый
pounding=битье
knife=нож;резать ножом;ножевой
praying=моление
vacation=оставление;каникулярный;брать отпуск
pressing=неотложный;сжатие
bearer=носильщик
muffled=закутанный
mad=сумасшедший;сходить с ума
intertwined=переплетенный
devout=набожный
raise=поднимать;повышение
condition=состояние;обусловливать
leak=давать течь;течь
tools=инструментарий
pouring=наливание;проливной
reeling=наматывание
swear=клясться;клятва
referring=относящийся к чему-л.
loaded=нагруженный
customs=таможенный;таможенные пошлины
loose=свободный;освобождать;выход;свободно
tarmac=гудронированное шоссе
sixty=шестьдесят;шестьдесят
skepticism=скептицизм
transparent=прозрачный
former=словолитчик;прежний
music=музыка
charged=заряженный
suicide=самоубийство;покончить с собой
chin=подносить к подбородку;подбородок
cockpit=арена для петушиных боев
faster=быстрее
blind=слепой;штора;ослеплять
priceless=бесценный
mesh=петля;поймать в сети
certainty=несомненный факт
ledge=край
country=страна;деревенский
towering=высокий
tennis=теннис
accustomed=привычный
stadium=стадион
food=пища
apt=подходящий
goal=цель
murderer=убийца
deposit=вклад в банк;класть в банк
married=женатый
positive=несомненный;позитив
protecting=защищающий
government=правительство
wooded=лесистый
therefore=поэтому
determined=решительный
involve=включать
pavement=тротуар
impressed=впечатленный
doctrine=доктрина
movement=движение
heat=жара;нагревать
faced=облицованный
narrowing=суживающийся;уменьшение
behavior=поведение
upset=опрокидывание;опрокидывать;опрокинутый
rugged=неровный
gravel=гравий;посыпать гравием
dilemma=дилемма
ponder=обдумывать;пестик
famed=прославленный
pond=пруд;запруживать
seeming=кажущийся;видимость
expansive=экспансивный
renowned=прославленный
imposing=производящий сильное впечатление
glory=слава;гордиться
absently=рассеянно
lifetime=продолжительность жизни
forty=сорок;сорок
windshield=переднее стекло
journey=поездка;путешествовать
audible=слышный
swallowed=проглоченный
referred=отраженный
prone=лежащий ничком;ничком
romantic=романтический;романтик
playful=игривый
encircled=окруженный
interested=заинтересованный
skyward=к небу;устремленный в небо
cement=цемент;скреплять цементом
destroyed=разрушенный
spend=тратить
folded=согнутый
dazzling=ослепительный
difference=разница;отличать
highly=очень
smoothly=гладко
changing=размен
animal=животный;животное
hatch=высиживать птенцов;люк
childhood=детство
zodiac=зодиак
begging=вымаливающий подаяние;нищенство
crossing=перечеркивание;пересекающий
settling=осадок
dimly=вполнакала
classroom=класс
iambic=ямбический;ямбический стих
limo=лимузин
recognition=узнавание
angry=сердитый
meter=счетчик;измерять
thrown=кинутый
evaporated=сгущенный
oil=масло;смазать;масляный
inspection=осмотр;инспекционный
lack=испытывать недостаток;недостаток
decor=орнамент
personally=лично
movie=кинофильм
high-tech=относящийся к современной технологии
neatly=аккуратно
tour=путешествие;совершать путешествие;гастрольный
rope=канат;привязывать;веревочный
sunlight=солнечный свет
painful=причиняющий боль
dim=тусклый;делать тусклым;темнота
worn=заношенный
niche=ниша;помещать в нишу
suffering=страдающий;страдание
stretched=вытянутый
stripped=раздетый
enemy=вражеский;враг
meaningless=бессмысленный
numbered=нумерованный
partially=частично
well-known=известный
immediate=непосредственный
knocking=стук
inverted=опрокинутый
confident=уверенный;наперсник
custody=опека
entresol=антресоли
flag=флаг;украшать флагами
indicator=указатель;индикаторный
microphone=микрофон
mock=насмехаться;поддельный;осмеяние
uncover=снимать
pronounced=явный
cooler=прохладительный напиток
accused=обвиняемый;обвиняемый
generally=обычно
postscript=постскриптум
derived=вырезанный
persuasive=побуждение;убедительный
finish=кончать;конец
draft=тягловый;тяга;делать чертеж
spiral=спиральный;спираль
shrine=рака;благоговейно хранить
people's=народный
shell=раковина;очищать от скорлупы
allegory=аллегория
conceived=понятый
grow=расти
metallic=металлический
add=прибавлять
expect=ожидать
proposed=предложенный
currently=теперь
abandoned=покинутый
debt=долг
begun=начатый
shroud=саван;завертывать в саван
trail=анонсировать кинофильм или телефильм;след
wake=просыпаться;бодрствование
awaiting=в ожидании
layout=показ
foil=подчеркивать;фольга
shut=затворять;закрытый
damned=ужасный
mail=почта;посылать по почте;почтовый
drag=медленное движение;тащить
silver=серебро;серебрить;серебряный
potent=сильный
glove=надевать перчатку;перчатка
openly=открыто
fly=летать;муха;осмотрительный
slightly=слегка
affairs=дела
underside=нижняя часть
activated=активированный
noise=шум;разглашать
bringing=приносящий;привоз
profoundly=глубоко
bright=яркий;блестяще;яркость
dire=ужасный
multiple=составной;кратное число
progression=продвижение
keypad=клавиатура
typing=переписка на машинке
expertise=специальные знания
laptop=портативный компьютер;наколенный
realization=осуществление
banking=банковское дело;банкирский
immaterial=невещественный
strike=ударять;удар;забастовочный
uniform=однообразный;форменная одежда;одевать в форму
coordinates=координаты
rock=скала;качать;горный
fail=терпеть неудачу;неудача
hayloft=сеновал
approximately=приближенно
accented=подчеркнутый
sworn=названный
jail=тюрьма;заключать в тюрьму
clearance=очистка
crawl=ползать;ползание
fugitive=беглец;беглый
transported=транспортированный
carpet=ковер;устилать
prize=награда;призовой;высоко ценить
imagination=воображение
softening=смягчение
weather=выдерживать;погодный;погода
inform=сообщать
conference=конференция
grin=ухмыляться;оскал
shift=перемещение;перемещать
coldly=холодно
embarrassed=смущенный
chapter=глава;разбивать книгу на главы
spotted=пятнистый
offices=службы при доме
travel=путешествовать;путешествие;дорожный
draw=тащить;тяга
ridiculous=смехотворный
cupola=купол
difficult=трудный
roadblock=дорожное заграждение
bishop's=епископский
diamonds=бубны
scream=пронзительно кричать;пронзительный крик
allusion=ссылка
fervent=горячий
encouraged=ободренный
loading=погрузка;погрузочный
potential=потенциал;потенциальный
join=соединять;соединение
oddity=чудак
one's=чей-либо
passage=прохождение;пересекать
teaching=обучение
age=возраст;стареть
wealth=богатство
exhaustion=истощение
suspicion=подозрение
zero=нуль;ноль;нулевой;устанавливать на нуль
prime=воспламенять;первоначальный;начало
patiently=терпеливо
reply=ответ;отвечать
powered=механизированный
runway=дорожка
monster=урод;огромный
ship=перевозить груз;корабль
seldom=редко
reluctantly=неохотно
remorse=угрызения совести
cause=причина;быть причиной
refuge=убежище;давать убежище
coarse=грубый
trash=отбросы;очищать от мусора
student=изучающий;студент
barbed=с колючками
appearance=внешний вид
stack=стог;складывать в стог
ocean=океан;океанский
highway=автострада;дорожный
echo=отдаваться (о звуке);эхо
item=также;пункт;записывать по пунктам
thank=благодарить;благодарность
obtain=получать
tighten=сжимать
faded=линялый
column=колонна
loud=громкий;громко
genealogy=генеалогия
polite=вежливый
incident=случай;свойственный
widely=широко
haunted=часто посещаемый
hatred=ненависть
lowering=темный;опущение
purchased=покупной
ticket=удостоверение;прикреплять ярлык;билетный
bury=хоронить
fight=вести бой;бой
peace=мир;мирный
hood=капюшон;покрывать капюшоном
reddish=красноватый
scholar=ученый
casting=бросание;литейный
amount=составлять сумму;количество
receive=получать
easier=легче
invented=изобретенный
bond=бона;подписывать обязательства;крепостной
aluminum=алюминиевый;алюминий
trace=набрасывать (документ, рисунок);след
castle=з`амок;рокировать
correctly=правильно
scheme=программа;замышлять
slope=уклон;иметь наклон;покатый
statue=статуя
roar=реветь;рев
individual=личный;личность
indicate=указывать
fence=забор;ограждать
absent=отсутствовать;отсутствующий;без
compound=смешивать;соединение;составной
gruff=грубоватый
persuade=убеждать
substantial=прочный
accompanying=сопровождающий
suspicious=подозрительный
creative=творческий
papal=папский
monogram=монограмма
evaporate=испарять
invitation=приглашение
furniture=мебель
eliminated=устраненный
plush=плюшевый;плюш
replaced=замененный
curved=изогнутый
collage=коллаж
double=двойное количество;удваивать;двойной;вдвое
luxury=люкс
cloister=монастырь;заточать в монастырь
buying=купля
rank=строить в шеренгу;буйный;ряд
smear=смазывать;пятно
testimony=показание свидетеля
desire=желание;желать
deepening=углубление
corrected=исправленный
admitted=признанный
enlightened=просвещенный
elements=основы
importance=значение
startling=поразительный
misconception=неправильное представление
result=результат;следовать
guy=пугало;выставлять на посмешище
summoned=вызванный
prophet=предсказатель
gods=галерка
harmony=гармония
paid=оплаченный
swag=награбленное добро;раскачиваться
nighttime=ночь;ночью
astronomy=астрономия
expensive=дорогой
cellular=клеточный
astonished=изумленный
flabbergasted=изумленный
quote=цитировать;цитата
framed=обрамленный
fair=честный;честно;ярмарка
tight=туго завязанный;плотно;трудное положение
damage=вред;повреждать
movies=кино
gut=кишка;потрошить;инстинктивный
regret=сожаление;сожалеть
glorious=великолепный
converted=новообращенный
con=заучивать наизусть;жульничество;жульнический;против
frustrated=несостоявшийся
virgin=девственный;дева
campaign=кампания;участвовать в походе
simplest=самый простой
display=показ;показывать
thus=так
erased=стертый
protruding=выдающийся;навыкат
recast=придание новой формы;переделывать
applied=прикладной
protocol=протокол;протоколировать
betrayal=предательство
plethora=полнокровие
tearful=плачущий
deadly=смертельный;смертельно
consider=рассматривать
reality=действительность
stylus=перо прибора
nun=монахиня
site=место;располагать
smug=зубрила;самодовольный;украшать
rod=прут
leveled=выровненный
obscure=темный;затушевывать
neath=под
teeth=зубы
tuxedo=смокинг
rough-hewn=неотесанный
haze=туман;заволакивать
disappointment=разочарование
rightful=законный
reasonable=разумный;умеренно
grasp=схватывать;сжатие
waits=христославы
shoes=обувь
mask=маска;маскировать
endorse=делать передаточную надпись
glint=вспышка;вспыхивать
incredulity=недоверчивость
transmitting=передающий
lucrative=прибыльный
sprawling=ползучий;беспорядочный рост
horrific=ужасающий
crystal=кристалл;кристаллический
cavernous=изобилующий пещерами
type=тип;печатать
gunshot=дальность выстрела
loudly=громко
bolt=засов;закрывать на засов
admittedly=по общему признанию
warning=предостережение;предупреждающий
accurate=точный
crash=падать;грохот;аварийный;с грохотом
wedged=клинообразный
influential=влиятельный
construction=строительство
ingenious=изобретательный
valley=долина
party=партия;партийный
extra=добавочный;приплата;особо
moonlight=подвергаться ночному нападению;лунный свет
twinkling=мерцание;мерцающий
mouse=ловить мышей;мышь
pushing=энергичный
unexpectedly=неожиданно
icon=икона
painter=художник
notorious=пользующийся дурной славой
officially=формально
teacher=учитель
backed=со спинкой
allegedly=будто бы
terror=ужас
landed=земельный
visiting=посещающий
persuaded=убежденный
generous=великодушный
overwhelming=несметный
sales=распродажа по сниженным ценам;торговый
suggestion=предложение
accusation=обвинение
peculiar=специфический;личная собственность
pleasure=удовольствие;доставлять удовольствие;увеселительный
accelerator=ускоритель
thanks=благодарность
guidance=руководство
normally=нормально
neighborhood=соседство
applying=использование
social=общественный;собрание
women's=женский
exceptional=исключительный
rights=правые
gratitude=благодарность
progress=прогресс;прогрессировать
cleansing=очищающий
bordered=окаймленный
eagerly=горячо
motivation=побуждение
privy=частный;заинтересованное лицо
lovely=красивый;красотка
index=индекс;снабжать указателем
create=создавать
aspect=вид;видовое (о сказуемом)
whoever=кто бы ни
fellow=человек;дружески обращаться
existence=существование
mounted=конный
attendance=присутствие
fist=кулак;ударить кулаком
muscle=мышца
torch=факел;освещать факелами
e-mail=электронная почта
faithful=верный;верующие
tag=свободный конец;прикреплять ярлык
gentle=мягкий;делать мягче;наживка
brick=кирпич;класть кирпичи;кирпичный
riding=верховой;верховая езда
liability=ответственность
sink=тонуть;раковина
funds=государственные процентные бумаги
song=песня
schematic=схема;схематический
ministry=министерство
bridge=мост;строить мост
expressing=выражающий
mocking=осмеяние
bronze=бронза;бронзировать;бронзовый
blueprint=синька;делать светокопию
publicly=публично
demanding=требовательный
interrupted=прерванный
specifics=конкретика
bait=насаживать наживку на крючок;приманка
packed=упакованный
equipped=оборудованный
ploy=уловка
synonymous=синонимический
belly=живот;надуваться
feature=черта лица;быть характерной чертой
penchant=склонность
roots=корнеплоды
rural=сельский
crossword=кроссворд
phallus=фаллос
talented=талантливый
humble=скромный;смирять
commissioned=облеченный полномочиями
transmission=передача
nonetheless=тем не менее
waist=талия
hospital=больница
sunny=солнечный;солнечно
ignore=пренебрегать
filling=заполнение;автозаправочный
fool=баловаться;дурак;глупый
victim=жертва
balanced=уравновешенный
sedan=седан
breaker=взломщик
voted=проголосовавший
handcuffs=наручники
uncomfortable=неудобный
sleepy=сонный
dome=купол;венчать куполом
thoroughfare=оживленная улица
cryptography=криптография
sidewalk=пешеходная дорожка
amethyst=аметистовый;аметист
interpretation=толкование
delivery=доставка;нагнетательный
department=отдел;ведомственный
wife=жена
proving=утверждение
looming=мираж;смутный
custom=обычай;изготовленный на заказ
intrusion=вторжение
attractive=притягательный
noble=благородный;дворянин
swinging=качающийся;качание
layer=слой;класть пластами
sentence=приговор;осуждать
restore=возвращать
defense=защита
twin=являющийся близнецом;двойня;родить двойню
fluid=жидкий;жидкость
motionless=неподвижный
whipped=выпоротый
radar=радиолокатор;радиолокационный
pry=подглядывать;любопытство;любопытный
enthusiasm=энтузиазм
fade=вянуть
bulletin=бюллетень;выпускать бюллетень
earned=заработанный
merit=заслуга;заслужить
negative=отрицание;делать тщетным;отрицательный
launch=спускать на воду;спуск судна на воду
beating=битье
resolute=твердый
crisp=хрустящий;делать хрустящим;хрустящий картофель
courtesy=вежливость
detail=подробно рассказывать;деталь;детальный
gloomy=мрачный
leader=руководитель
pulse=пульс;пульсировать
spirit=душа;тайно похищать;спиритический
fuselage=фюзеляж
abruptly=внезапно
holster=кобура
relate=член отношения;рассказывать
sweeping=широкий;уборка
learning=изучение;изучающий
alleged=утверждаемый
demonic=дьявольский
philosophy=философия
switchboard=щит управления
furrowed=бороздчатый
context=контекст
bookshelf=книжная полка
relevant=уместный
initially=сначала
root=корень;пускать корни;коренной
ghostly=призрачный
climax=высшая точка;доходить до кульминационного пункта
bull=бык;бычачий;повышаться в цене
constant=постоянный;постоянная величина
eradicate=вырывать с корнем
patrol=патрулировать;патруль;патрульный
launched=запущенный (куда-л.)
era=эра
crumpled=жеваный
turmoil=беспорядок
selling=продажа
presenting=предъявляемый;предъявление
exploded=взорванный
sanctity=святость
wise=мудрый;способ;надоумить
witch=ведьма;околдовать
husband=экономно вести хозяйство;муж
proudly=гордо
bay=бухта;лаять;гнедой
covering=покрышка;сопроводительный
load=грузить;груз
cruel=жестокий
hang=вешать;вид
ram=баран;ударить
spread-eagle=распластанный;орел с распростертыми крыльями;распластать
foremost=передний;во-первых
silenced=заглушенный
reconsider=пересматривать
partition=раздел;делить
spell=околдовывать;заклинание
pathetic=трогательный
glare=яркий свет;ослепительно сверкать;гладкий и прозрачный
rectory=дом приходского священника
breathing=дышащий;дыхание
tear=разрывать;разрыв
matching=сопоставление;сочетающийся
analysis=анализ
aging=созревание;стареющий
sexuality=различие полов
association=ассоциация
describe=описывать
austerity=строгость
colorful=красочный
deceived=обманутый
etymological=этимологический
bell=колокол;прикреплять колокольчик
shadowy=тенистый
cloth=ткань;свертываться;суконный
admiring=восхищенный
clutch=когти;схватить;надежный
spiked=колосистый
misty=туманный
resembling=похожий
deity=божественность
compared=сравненный
miracle=чудо
loving=любящий
compassion=сочувствие;сочувствовать
stopping=остановка
undertow=отлив прибоя
writer=писатель
locking=запирание;запирающий
circled=окруженный
struck=ударенный
identifying=идентифицирующий
forsaken=покинутый
thunder=греметь;гром
recall=отзывать;отозвание
laughter=смех
hostess=хозяйка
imaginary=воображаемый
fake=подделывать;подделка
assorted=сортированный
beat=бить;удар;усталый
regularly=правильно
practice=практика;практиковать;практический
defend=защищать
involving=включающий в себя
gibberish=невнятная речь
waving=волнение
permitting=позволяющий
watermark=отметка уровня воды;делать водяные знаки
airborne=бортовой
stiff=жесткий;вексель;до изнеможения
originally=первоначально
assistance=помощь
cast=бросок;бросать
fluorescent=флюоресцентный
consistent=совместимый
outcast=изгнанный;изгнанник
researching=исследующий
airfield=аэродром
hopeful=многообещающий;человек, подающий надежды
redeem=выкупать
fish=рыба;ловить рыбу;рыбный
projector=проектировщик
tattered=драный
refined=утонченный
patient=терпеливый;больной
ratio=отношение;устанавливать соотношение
stationary=неподвижный
revolving=вращающийся
shrouded=закутанный
o'er=над
introduction=официальное представление
casket=шкатулка
investment=инвестирование
eighteen=восемнадцать;восемнадцать
town=город;городской;превращать в город
diameter=диаметр
flowering=цветущий;цветение
worry=надоедать;беспокойство
arrangement=приведение в порядок
yellow=желтый;желтизна;желтеть
tube=камера шины;заключать в трубу
hypertext=гипертекст
trial=испытание;испытательный
depicted=изображенный
climb=карабкаться;подъем
split=расщеплять;сладкое блюдо;расколотый
girls=девчата
impression=впечатление
tumbling=акробатика
payment=уплата
evident=очевидный
sad=печальный;минор
delirious=находящийся в бреду
strings=струнные инструменты оркестра
produce=продукция;предъявлять
video=телевидение;телевизионный
semester=семестр
thrill=нервная дрожь;вызывать трепет
remind=напоминать
heaving=подъем
outskirts=окраина
vain=тщетный;тщета
range=ряд;выстраивать в ряд;аккуратный
feed=кормить;питание;загрузочный
shirt=рубашка;надевать рубашку
unmistakable=безошибочный
enjoy=получать удовольствие
commanding=командующий
somebody=кто-то;важная персона
heads=руда
scrambled=взбитый
endorsement=передаточная надпись
infinitely=бесконечно
chartered=привилегированный
receptionist=секретарь в приемной
compass=компас;окружать;компасный
thirteenth=тринадцатое число;тринадцатый;тринадцатый
bags=мешки под глазами
simultaneously=одновременно
blow=дуть;удар
guttural=гортанный;велярный звук
supplies=запас
dramatically=драматично
build=форма;строить
rumbling=бурчание
expressed=выраженный
distaste=неприязнь;испытывать неприязнь
dominated=подавленный
doorstep=порог
spacious=обширный
thankful=благодарный
plausible=правдоподобный
rate=норма;оценивать
unto=к
torn=разорванный
unfathomable=бездонный
storm=буря;бушевать
shake=трясти;встряска
pious=набожный
earthquake=землетрясение
groggy=нетвердый на ногах
basic=основной;бейсик
jolt=трясти;толчок
freed=освобожденный
locks=волосы
tingle=испытывать покалывание;пощипывание
leading=ведущий;руководство
style=стиль;величать
engraving=гравирование;гравировальный
stamped=тисненый
grace=грация;украшать
wonderment=удивление
receiving=принимающий;укрывательство краденого
mental=умственный;ненормальный
employee=работник
crippled=изувеченный
causing=вызывающий что-л.
ultramodern=ультрасовременный
confidential=конфиденциальный
nervously=нервно
adrenaline=адреналин
guarding=держание
communications=коммуникации
plaster=штукатурить;штукатурка
gangway=сходня
displayed=с распростертыми крыльями
army=армия;армейский
careful=заботливый
fare=плата за проезд;поживать
commonly=обычно
clever=умный
skilled=умелый
stated=установленный
blossom=цвести;цвет
earthly=земной
potentially=потенциально
lined=линованный
puzzling=приводящий в замешательство
lucky=случайный
stage=сцена;ставить;сценический
pretended=притворный
succeed=достигать цели
accelerating=ускоряющий
flagging=мощение плитняком;никнущий
granite=гранит
horn=рог;бодать;роговой
cooperate=сотрудничать
historic=исторический
eagerness=пыл
soaking=намокание;пропитывающий
ominous=зловещий
symmetry=симметрия
slash=порезать;резкий удар
fee=гонорар;платить гонорар
bearing=ношение;несущий
divided=разделенный
apex=вершина
doubtful=сомневающийся
hardwood=твердая древесина
dare=сметь;вызов
siren=сирена
putting=толкание
tender=нежный;лицо, присматривающее за кем-л.;предоставлять
alternate=чередоваться;чередующийся;дублер
graduated=дипломированный
rapid=быстрый;порог реки
decoy=приманивать;пруд, затянутый сеткой
simplistic=упрощенный
establishment=установление
frowning=хмурый
descendant=происходящий;потомок
conclusive=заключительный
palace=дворец;дворцовый
nerve=нерв;придавать силу;нервный
actual=настоящий
companion=товарищ;быть компаньоном;парный
owe=быть должным
plain=ясный;ясно;жаловаться;равнина
wool=шерсть;шерстяной
defiant=вызывающий
intervention=вмешательство
breathless=задыхающийся
ideal=идеальный;верх совершенства
dresser=франт
shocked=потрясенный
penmanship=каллиграфия
horned=рогатый
biblical=библейский
relevance=уместность
belong=принадлежать
allowing=позволяющий
menacing=угрожающий
admired=возлюбленный
cleaner=уборщик
claiming=претендующий
appointment=назначение
mat=мат;устилать циновками;неполированный
gather=собирать;сбор
bite=кусать;укус
bear=переносить;медведь
alcohol=спирт
cleaned=убранный
unnatural=неестественный
clothes=одежда
honest=честный
jagged=зазубренный
approach=подходить;приближение
normal=нормальный;нормальное состояние
separate=отделять;отдельный;отдельный оттиск
intently=сосредоточенно
suspended=подвешенный
deafening=оглушительный;звукоизолирующий материал
mostly=главным образом
chores=домашняя работа
pillow=подушка;класть голову на что-л.
horns=усики
contour=контур;наносить контур;контурный
arrested=арестованный
destruction=разрушение
awash=качающийся на волнах;на поверхности воды
sooner=скорее
invariably=неизменно
rolling=прокатка;вращающийся
intermittent=прерывистый
dog=собака;выслеживать
specifically=особенно
hate=ненависть;ненавидеть
someday=как-нибудь на днях
discharged=разряженный
deal=распределять;некоторое количество;сосновый
blessing=благословение
pang=острая боль;причинять острую боль
forgiveness=прощение
knot=узел;завязывать узел
bench=скамейка;демонстрировать на выставке
departure=отъезд;исходный
baggage=багаж;багажный
released=освобожденный
inwardly=внутри
shocking=отвратительный;копнение;очень
surviving=выживающий
delay=задерживать;задержка
floating=плавание;плавучий
trepidation=тревога
unlock=отпирать
dignified=обладающий чувством собственного достоинства
wandering=бродячий;скитания
citadel=цитадель
navigate=плавать на судне
absurd=нелепый;абсурд
related=связанный
helpless=беспомощный
cliff=утес
tongue=язык;трогать языком;языковый
extract=экстракт;извлекать
soaring=парящий;пар`ение
angrily=сердито
sharing=дележ
summer=период расцвета;проводить лето
sharply=точно
stretching=натяжной;растягивание
devastating=опустошительный
handwritten=написанный от руки
mood=расположение духа
chat=болтовня;болтать
hearts=червы
sold=проданный
rewrite=переработанный текст;переписывать
watchman=ночной сторож
reverberating=звучащий
liberal=свободомыслящий;либерал
unprecedented=беспрецедентный
rigid=жесткий
web=ткань;опутывать паутиной
captured=захваченный
success=успех
stalking=облава
veil=вуаль;закрывать покрывалом
face to face=без посторонних
taste=вкус;пробовать
fading=увядание;затухающий
shelter=приютить;кров
sublime=возвышенный;возвышать
veneration=почитание
cradling=качание в люльке
documented=документированный
product=продукт
outline=контур;обрисовывать;контурный
program=программа;составлять программу;программный
ranks=масса
swirling=кружащийся
insane=душевнобольной;душевнобольной
horizon=горизонт
silk=шелк;шелковый
countryside=деревня
advised=обдуманный
injured=поврежденный;пострадавший
catching=заразный;ловля
grassy=покрытый травой
portrait=портрет;вертикальный
hunting=охота;охотничий
dotted=пунктирный
platform=платформа;помещать на платформу
flatly=решительно
rub=тереть;трение
androgynous=двуполый
playfully=игриво
nearest=ближайший
anymore=больше не
coincide=совпадать
clarify=очищать
deception=обман
banker's=банкирский
glimmer=мерцание;мерцать
unison=унисон
enduring=прочный
demand=требование;требовать
senior=пожилой человек;старший
skies=климат
constructed=созданный
stored=запасенный
guaranteed=гарантированный
rental=сумма арендной платы
recorded=записанный
appearing=фигурирующий
flawless=безупречный
politely=вежливо
insert=вставлять;вставка
crying=кричащий;крик
celebrated=знаменитый
thundering=громоподобный;очень
propaganda=пропаганда
stronger=более сильный
peaceful=мирный
click=щелчок;щелкать
originated=порожденный
otherwise=иначе;иной
locate=устанавливать
sometimes=иногда
pot=горшок;консервировать
bottle=бутылка;разливать по бутылкам;бутылочный
medical=врачебный;студент-медик
sailing=плавание;парусный
track=след;следить
ray=излучать;луч;лучевой
foundation=основание